"Team_ID","Season","Team","Seed","Seed_num","Seed_Pre","Seed_Diff"
"2004_1102",2004,1102,"W11",11,20,9
"2006_1102",2006,1102,"Z13",13,20,7
"1986_1103",1986,1103,"X15",15,20,5
"2009_1103",2009,1103,"X13",13,20,7
"2011_1103",2011,1103,"Z15",15,20,5
"2013_1103",2013,1103,"X12",12,20,8
"1985_1104",1985,1104,"X07",7,20,13
"1986_1104",1986,1104,"Y05",5,7,2
"1987_1104",1987,1104,"X02",2,5,3
"1989_1104",1989,1104,"Z06",6,20,14
"1990_1104",1990,1104,"Z07",7,6,-1
"1991_1104",1991,1104,"X04",4,7,3
"1992_1104",1992,1104,"Z05",5,4,-1
"1994_1104",1994,1104,"X09",9,20,11
"1995_1104",1995,1104,"W05",5,9,4
"2002_1104",2002,1104,"Y02",2,20,18
"2003_1104",2003,1104,"Y10",10,2,-8
"2004_1104",2004,1104,"X08",8,10,2
"2005_1104",2005,1104,"X05",5,8,3
"2006_1104",2006,1104,"X10",10,5,-5
"2012_1104",2012,1104,"X09",9,20,11
"2005_1105",2005,1105,"Z16a",16,20,4
"2001_1106",2001,1106,"Z16",16,20,4
"2004_1106",2004,1106,"W16",16,20,4
"2009_1106",2009,1106,"Y16a",16,20,4
"2011_1106",2011,1106,"W16a",16,20,4
"2006_1107",2006,1107,"Z16",16,20,4
"2007_1107",2007,1107,"X13",13,16,3
"2013_1107",2013,1107,"Y15",15,20,5
"2014_1107",2014,1107,"X16a",16,15,-1
"2015_1107",2015,1107,"W14",14,16,2
"1999_1108",1999,1108,"Z15",15,20,5
"2002_1108",2002,1108,"W16a",16,20,4
"2008_1110",2008,1110,"W15",15,20,5
"2009_1110",2009,1110,"W14",14,15,1
"2014_1110",2014,1110,"Z15",15,20,5
"2000_1111",2000,1111,"X14",14,20,6
"1985_1112",1985,1112,"X10",10,20,10
"1986_1112",1986,1112,"Z09",9,10,1
"1987_1112",1987,1112,"Z10",10,9,-1
"1988_1112",1988,1112,"Z01",1,10,9
"1989_1112",1989,1112,"X01",1,1,0
"1990_1112",1990,1112,"Z02",2,1,-1
"1991_1112",1991,1112,"Z02",2,2,0
"1992_1112",1992,1112,"Z03",3,2,-1
"1993_1112",1993,1112,"Z02",2,3,1
"1994_1112",1994,1112,"Z02",2,2,0
"1995_1112",1995,1112,"Y05",5,2,-3
"1996_1112",1996,1112,"Z03",3,5,2
"1997_1112",1997,1112,"X04",4,3,-1
"1998_1112",1998,1112,"X01",1,4,3
"1999_1112",1999,1112,"X04",4,1,-3
"2000_1112",2000,1112,"Z01",1,4,3
"2001_1112",2001,1112,"Y02",2,1,-1
"2002_1112",2002,1112,"Z03",3,2,-1
"2003_1112",2003,1112,"Z01",1,3,2
"2004_1112",2004,1112,"W09",9,1,-8
"2005_1112",2005,1112,"X03",3,9,6
"2006_1112",2006,1112,"Y08",8,3,-5
"2007_1112",2007,1112,"Y08",8,8,0
"2008_1112",2008,1112,"Z10",10,8,-2
"2009_1112",2009,1112,"Y12",12,10,-2
"2011_1112",2011,1112,"X05",5,20,15
"2013_1112",2013,1112,"Z06",6,20,14
"2014_1112",2014,1112,"Z01",1,6,5
"2015_1112",2015,1112,"Z02",2,1,-1
"2016_1112",2016,1112,"Y06",6,2,-4
"2017_1112",2017,1112,"X02",2,6,4
"1991_1113",1991,1113,"X08",8,20,12
"1995_1113",1995,1113,"Z05",5,20,15
"2003_1113",2003,1113,"Z10",10,20,10
"2009_1113",2009,1113,"X06",6,20,14
"2014_1113",2014,1113,"Y10",10,20,10
"1986_1114",1986,1114,"X14",14,20,6
"1989_1114",1989,1114,"Y13",13,20,7
"1990_1114",1990,1114,"Z16",16,13,-3
"2011_1114",2011,1114,"Y16a",16,20,4
"2016_1114",2016,1114,"X12",12,20,8
"2010_1115",2010,1115,"X16a",16,20,4
"1985_1116",1985,1116,"X09",9,20,11
"1988_1116",1988,1116,"Y11",11,20,9
"1989_1116",1989,1116,"Y05",5,11,6
"1990_1116",1990,1116,"X04",4,5,1
"1991_1116",1991,1116,"X01",1,4,3
"1992_1116",1992,1116,"Y03",3,1,-2
"1993_1116",1993,1116,"W04",4,3,-1
"1994_1116",1994,1116,"Y01",1,4,3
"1995_1116",1995,1116,"Y02",2,1,-1
"1996_1116",1996,1116,"W12",12,2,-10
"1998_1116",1998,1116,"X06",6,20,14
"1999_1116",1999,1116,"Z04",4,6,2
"2000_1116",2000,1116,"X11",11,4,-7
"2001_1116",2001,1116,"X07",7,11,4
"2006_1116",2006,1116,"X08",8,20,12
"2007_1116",2007,1116,"W12",12,8,-4
"2008_1116",2008,1116,"W09",9,12,3
"2015_1116",2015,1116,"Z05",5,20,15
"2017_1116",2017,1116,"Z08",8,20,12
"1999_1117",1999,1117,"X15",15,20,5
"1985_1120",1985,1120,"Z11",11,20,9
"1986_1120",1986,1120,"Z08",8,11,3
"1987_1120",1987,1120,"Y08",8,8,0
"1988_1120",1988,1120,"Y08",8,8,0
"1999_1120",1999,1120,"Y01",1,20,19
"2000_1120",2000,1120,"Y07",7,1,-6
"2003_1120",2003,1120,"W10",10,20,10
"1987_1122",1987,1122,"X14",14,20,6
"1996_1122",1996,1122,"Y14",14,20,6
"2003_1122",2003,1122,"W13",13,20,7
"2008_1122",2008,1122,"Y15",15,20,5
"2016_1122",2016,1122,"Y16",16,20,4
"1986_1123",1986,1123,"Y14",14,20,6
"1989_1123",1989,1123,"Y09",9,20,11
"1990_1123",1990,1123,"Z12",12,9,-3
"1993_1123",1993,1123,"X15",15,20,5
"1995_1123",1995,1123,"Z12",12,20,8
"2000_1123",2000,1123,"Y11",11,20,9
"1988_1124",1988,1124,"X08",8,20,12
"2008_1124",2008,1124,"Z11",11,20,9
"2010_1124",2010,1124,"X03",3,20,17
"2012_1124",2012,1124,"Y03",3,20,17
"2014_1124",2014,1124,"Z06",6,20,14
"2015_1124",2015,1124,"Z03",3,6,3
"2016_1124",2016,1124,"Z05",5,3,-2
"2017_1124",2017,1124,"W03",3,5,2
"2006_1125",2006,1125,"X15",15,20,5
"2007_1125",2007,1125,"W15",15,15,0
"2008_1125",2008,1125,"Z15",15,15,0
"2011_1125",2011,1125,"Y13",13,20,7
"2012_1125",2012,1125,"X14",14,13,-1
"2013_1125",2013,1125,"Z11",11,14,3
"2015_1125",2015,1125,"W15",15,20,5
"2009_1127",2009,1127,"W15",15,20,5
"1988_1129",1988,1129,"Z14",14,20,6
"1993_1129",1993,1129,"Z14",14,20,6
"1994_1129",1994,1129,"Z14",14,14,0
"2008_1129",2008,1129,"W14",14,20,6
"2013_1129",2013,1129,"Z13a",13,20,7
"2015_1129",2015,1129,"W11a",11,20,9
"1985_1130",1985,1130,"Y11",11,20,9
"1994_1130",1994,1130,"W09",9,20,11
"1996_1130",1996,1130,"Y11",11,20,9
"1997_1130",1997,1130,"Z05",5,11,6
"2001_1130",2001,1130,"W03",3,20,17
"2002_1130",2002,1130,"X11",11,3,-8
"2004_1130",2004,1130,"Z06",6,20,14
"2005_1130",2005,1130,"X04",4,6,2
"2006_1130",2006,1130,"Y04",4,4,0
"2007_1130",2007,1130,"W07",7,4,-3
"2009_1130",2009,1130,"Y07",7,20,13
"1988_1131",1988,1131,"W15",15,20,5
"1990_1131",1990,1131,"W16",16,20,4
"1997_1131",1997,1131,"Y12",12,20,8
"2002_1131",2002,1131,"Z16",16,20,4
"2011_1131",2011,1131,"Z16",16,20,4
"1986_1133",1986,1133,"Z07",7,20,13
"1988_1133",1988,1133,"Y09",9,20,11
"1996_1133",1996,1133,"W08",8,20,12
"2006_1133",2006,1133,"X13",13,20,7
"1986_1135",1986,1135,"W15",15,20,5
"1987_1137",1987,1137,"X16",16,20,4
"1989_1137",1989,1137,"Y15",15,20,5
"2005_1137",2005,1137,"Z14",14,20,6
"2006_1137",2006,1137,"X09",9,14,5
"2011_1137",2011,1137,"X14",14,20,6
"2013_1137",2013,1137,"W11",11,20,9
"2017_1137",2017,1137,"X13",13,20,7
"2015_1138",2015,1138,"Y12",12,20,8
"2016_1138",2016,1138,"Y14",14,12,-2
"1997_1139",1997,1139,"Y14",14,20,6
"1998_1139",1998,1139,"Z13",13,14,1
"2000_1139",2000,1139,"W12",12,20,8
"2001_1139",2001,1139,"Y10",10,12,2
"2003_1139",2003,1139,"W12",12,20,8
"2007_1139",2007,1139,"Y05",5,20,15
"2008_1139",2008,1139,"W07",7,5,-2
"2009_1139",2009,1139,"X09",9,7,-2
"2010_1139",2010,1139,"Z05",5,9,4
"2011_1139",2011,1139,"Y08",8,5,-3
"2013_1139",2013,1139,"W06",6,20,14
"2015_1139",2015,1139,"Y06",6,20,14
"2016_1139",2016,1139,"X09",9,6,-3
"2017_1139",2017,1139,"Z04",4,9,5
"1987_1140",1987,1140,"X10",10,20,10
"1988_1140",1988,1140,"Y04",4,10,6
"1990_1140",1990,1140,"W12",12,20,8
"1991_1140",1991,1140,"Z10",10,12,2
"1992_1140",1992,1140,"X10",10,10,0
"1993_1140",1993,1140,"X07",7,10,3
"1995_1140",1995,1140,"Z08",8,20,12
"2001_1140",2001,1140,"X12",12,20,8
"2003_1140",2003,1140,"X12",12,20,8
"2004_1140",2004,1140,"X12",12,12,0
"2007_1140",2007,1140,"X08",8,20,12
"2008_1140",2008,1140,"Z08",8,8,0
"2009_1140",2009,1140,"Z08",8,8,0
"2010_1140",2010,1140,"Z07",7,8,1
"2011_1140",2011,1140,"Y03",3,7,4
"2012_1140",2012,1140,"Z14a",14,3,-11
"2014_1140",2014,1140,"Z10",10,20,10
"2015_1140",2015,1140,"Z11a",11,10,-1
"1987_1141",1987,1141,"Z13",13,20,7
"2003_1141",2003,1141,"Z11",11,20,9
"2014_1142",2014,1142,"Y16a",16,20,4
"1990_1143",1990,1143,"W09",9,20,11
"1993_1143",1993,1143,"X06",6,20,14
"1994_1143",1994,1143,"Z05",5,6,1
"1996_1143",1996,1143,"X12",12,20,8
"1997_1143",1997,1143,"W05",5,12,7
"2001_1143",2001,1143,"Z08",8,20,12
"2002_1143",2002,1143,"Y06",6,8,2
"2003_1143",2003,1143,"W08",8,6,-2
"2006_1143",2006,1143,"W07",7,20,13
"2009_1143",2009,1143,"Z07",7,20,13
"2010_1143",2010,1143,"X08",8,7,-1
"2012_1143",2012,1143,"X12a",12,20,8
"2013_1143",2013,1143,"W12",12,12,0
"2016_1143",2016,1143,"Y04",4,20,16
"1992_1144",1992,1144,"W16",16,20,4
"1996_1145",1996,1145,"X13",13,20,7
"2000_1148",2000,1148,"Y15",15,20,5
"2002_1148",2002,1148,"Y14",14,20,6
"2007_1148",2007,1148,"X16",16,20,4
"1997_1149",1997,1149,"Y15",15,20,5
"1988_1150",1988,1150,"Y13",13,20,7
"1992_1150",1992,1150,"W07",7,20,13
"1995_1150",1995,1150,"W07",7,20,13
"1997_1150",1997,1150,"Z07",7,20,13
"1998_1150",1998,1150,"W08",8,7,-1
"1999_1150",1999,1150,"X05",5,8,3
"2001_1150",2001,1150,"Y09",9,20,11
"2002_1150",2002,1150,"Y09",9,9,0
"2004_1150",2004,1150,"Y09",9,20,11
"2005_1150",2005,1150,"Z07",7,9,2
"1988_1151",1988,1151,"Y16",16,20,4
"1993_1151",1993,1151,"Y12",12,20,8
"1994_1151",1994,1151,"X13",13,12,-1
"1995_1151",1995,1151,"X15",15,13,-2
"1997_1151",1997,1151,"X14",14,20,6
"2005_1151",2005,1151,"W15",15,20,5
"2009_1151",2009,1151,"Z16",16,20,4
"2016_1151",2016,1151,"W12",12,20,8
"1992_1153",1992,1153,"Y04",4,20,16
"1993_1153",1993,1153,"W02",2,4,2
"1994_1153",1994,1153,"Z08",8,2,-6
"1995_1153",1995,1153,"X07",7,8,1
"1996_1153",1996,1153,"Y02",2,7,5
"1997_1153",1997,1153,"Y03",3,2,-1
"1998_1153",1998,1153,"X02",2,3,1
"1999_1153",1999,1153,"W03",3,2,-1
"2000_1153",2000,1153,"X02",2,3,1
"2001_1153",2001,1153,"X05",5,2,-3
"2002_1153",2002,1153,"Z01",1,5,4
"2003_1153",2003,1153,"Z08",8,1,-7
"2004_1153",2004,1153,"W04",4,8,4
"2005_1153",2005,1153,"Y07",7,4,-3
"2011_1153",2011,1153,"X06",6,20,14
"2012_1153",2012,1153,"W06",6,6,0
"2013_1153",2013,1153,"Y10",10,6,-4
"2014_1153",2014,1153,"W05",5,10,5
"2015_1153",2015,1153,"Y08",8,5,-3
"2016_1153",2016,1153,"Z09",9,8,-1
"2017_1153",2017,1153,"Z06",6,9,3
"1987_1155",1987,1155,"X04",4,20,16
"1989_1155",1989,1155,"X09",9,20,11
"1990_1155",1990,1155,"W05",5,9,4
"1996_1155",1996,1155,"Z09",9,20,11
"1997_1155",1997,1155,"Y04",4,9,5
"1998_1155",1998,1155,"Y06",6,4,-2
"2008_1155",2008,1155,"X05",5,20,15
"2009_1155",2009,1155,"X07",7,5,-2
"2010_1155",2010,1155,"W07",7,7,0
"2011_1155",2011,1155,"W12a",12,7,-5
"1986_1156",1986,1156,"W14",14,20,6
"2009_1156",2009,1156,"Y13",13,20,7
"1991_1157",1991,1157,"X15",15,20,5
"1993_1157",1993,1157,"Z16",16,20,4
"2014_1157",2014,1157,"W16",16,20,4
"2015_1157",2015,1157,"Z16",16,16,0
"1994_1158",1994,1158,"X12",12,20,8
"1997_1158",1997,1158,"X12",12,20,8
"1998_1158",1998,1158,"Y14",14,12,-2
"1999_1158",1999,1158,"W08",8,14,6
"1995_1159",1995,1159,"Y16",16,20,4
"1996_1159",1996,1159,"Y16",16,16,0
"1997_1160",1997,1160,"W09",9,20,11
"2003_1160",2003,1160,"X10",10,20,10
"2012_1160",2012,1160,"Y11",11,20,9
"2013_1160",2013,1160,"W10",10,11,1
"2014_1160",2014,1160,"X08",8,10,2
"2016_1160",2016,1160,"Y08",8,20,12
"1989_1161",1989,1161,"Y10",10,20,10
"1990_1161",1990,1161,"Z10",10,10,0
"2003_1161",2003,1161,"Z14",14,20,6
"2012_1161",2012,1161,"Z11",11,20,9
"2013_1161",2013,1161,"Y08",8,11,3
"1990_1163",1990,1163,"W01",1,20,19
"1991_1163",1991,1163,"Y11",11,1,-10
"1992_1163",1992,1163,"Z09",9,11,2
"1994_1163",1994,1163,"W02",2,20,18
"1995_1163",1995,1163,"X02",2,2,0
"1996_1163",1996,1163,"Y01",1,2,1
"1998_1163",1998,1163,"W02",2,20,18
"1999_1163",1999,1163,"Z01",1,2,1
"2000_1163",2000,1163,"X05",5,1,-4
"2002_1163",2002,1163,"W02",2,20,18
"2003_1163",2003,1163,"X05",5,2,-3
"2004_1163",2004,1163,"X02",2,5,3
"2005_1163",2005,1163,"Z02",2,2,0
"2006_1163",2006,1163,"Z01",1,2,1
"2008_1163",2008,1163,"Z04",4,20,16
"2009_1163",2009,1163,"Z01",1,4,3
"2011_1163",2011,1163,"X03",3,20,17
"2012_1163",2012,1163,"Y09",9,3,-6
"2014_1163",2014,1163,"W07",7,20,13
"2016_1163",2016,1163,"Y09",9,20,11
"1990_1164",1990,1164,"Y15",15,20,5
"1993_1164",1993,1164,"W15",15,20,5
"1997_1164",1997,1164,"W15",15,20,5
"2008_1164",2008,1164,"W16a",16,20,4
"1988_1165",1988,1165,"Z16",16,20,4
"2008_1165",2008,1165,"Y14",14,20,6
"2009_1165",2009,1165,"Z14",14,14,0
"2010_1165",2010,1165,"W12",12,14,2
"1989_1166",1989,1166,"Y14",14,20,6
"1991_1166",1991,1166,"Z11",11,20,9
"1999_1166",1999,1166,"Y10",10,20,10
"2000_1166",2000,1166,"Y10",10,10,0
"2001_1166",2001,1166,"W10",10,10,0
"2002_1166",2002,1166,"X12",12,10,-2
"2003_1166",2003,1166,"Z06",6,12,6
"2005_1166",2005,1166,"W10",10,20,10
"2007_1166",2007,1166,"X10",10,20,10
"2012_1166",2012,1166,"X08",8,20,12
"2013_1166",2013,1166,"Y07",7,8,1
"2014_1166",2014,1166,"Z03",3,7,4
"2017_1166",2017,1166,"Y06",6,20,14
"2016_1167",2016,1167,"Z15",15,20,5
"2008_1168",2008,1168,"X14",14,20,6
"2001_1169",2001,1169,"Y13",13,20,7
"2009_1169",2009,1169,"Z15",15,20,5
"1986_1172",1986,1172,"Y16",16,20,4
"1998_1172",1998,1172,"Z14",14,20,6
"2002_1172",2002,1172,"Z13",13,20,7
"2006_1172",2006,1172,"Y15",15,20,5
"2007_1172",2007,1172,"Y13",13,15,2
"2008_1172",2008,1172,"X10",10,13,3
"2012_1172",2012,1172,"Z13",13,20,7
"2013_1172",2013,1172,"W14",14,13,-1
"2015_1172",2015,1172,"X10",10,20,10
"1985_1173",1985,1173,"Z09",9,20,11
"1990_1173",1990,1173,"X12",12,20,8
"2000_1173",2000,1173,"Z11",11,20,9
"2003_1173",2003,1173,"Y04",4,20,16
"2004_1173",2004,1173,"X10",10,4,-6
"2009_1173",2009,1173,"Y11",11,20,9
"2014_1173",2014,1173,"X11",11,20,9
"2015_1173",2015,1173,"W11b",11,11,0
"2016_1173",2016,1173,"X07",7,11,4
"2017_1173",2017,1173,"Z07",7,7,0
"1992_1174",1992,1174,"Y13",13,20,7
"1993_1174",1993,1174,"X13",13,13,0
"1998_1174",1998,1174,"Y15",15,20,5
"1999_1174",1999,1174,"W13",13,15,2
"2014_1174",2014,1174,"W13",13,20,7
"2005_1175",2005,1175,"Y16",16,20,4
"1985_1177",1985,1177,"W10",10,20,10
"1986_1177",1986,1177,"W12",12,10,-2
"1987_1177",1987,1177,"Y03",3,12,9
"1988_1177",1988,1177,"X05",5,3,-2
"1989_1177",1989,1177,"X12",12,5,-7
"1991_1177",1991,1177,"Y09",9,20,11
"1992_1177",1992,1177,"X05",5,9,4
"2000_1177",2000,1177,"W09",9,20,11
"2004_1177",2004,1177,"X07",7,20,13
"1998_1178",1998,1178,"Y10",10,20,10
"1999_1178",1999,1178,"Y12",12,10,-2
"2012_1178",2012,1178,"X15",15,20,5
"2008_1179",2008,1179,"Z05",5,20,15
"1986_1180",1986,1180,"Z15",15,20,5
"1994_1180",1994,1180,"W13",13,20,7
"1995_1180",1995,1180,"W13",13,13,0
"1996_1180",1996,1180,"Z12",12,13,1
"1985_1181",1985,1181,"Y03",3,20,17
"1986_1181",1986,1181,"W01",1,3,2
"1987_1181",1987,1181,"Y05",5,1,-4
"1988_1181",1988,1181,"W02",2,5,3
"1989_1181",1989,1181,"W02",2,2,0
"1990_1181",1990,1181,"W03",3,2,-1
"1991_1181",1991,1181,"Y02",2,3,1
"1992_1181",1992,1181,"W01",1,2,1
"1993_1181",1993,1181,"X03",3,1,-2
"1994_1181",1994,1181,"X02",2,3,1
"1996_1181",1996,1181,"Y08",8,20,12
"1997_1181",1997,1181,"X02",2,8,6
"1998_1181",1998,1181,"Z01",1,2,1
"1999_1181",1999,1181,"W01",1,1,0
"2000_1181",2000,1181,"W01",1,1,0
"2001_1181",2001,1181,"W01",1,1,0
"2002_1181",2002,1181,"Y01",1,1,0
"2003_1181",2003,1181,"Z03",3,1,-2
"2004_1181",2004,1181,"W01",1,3,2
"2005_1181",2005,1181,"Y01",1,1,0
"2006_1181",2006,1181,"W01",1,1,0
"2007_1181",2007,1181,"Z06",6,1,-5
"2008_1181",2008,1181,"Z02",2,6,4
"2009_1181",2009,1181,"W02",2,2,0
"2010_1181",2010,1181,"X01",1,2,1
"2011_1181",2011,1181,"X01",1,1,0
"2012_1181",2012,1181,"Y02",2,1,-1
"2013_1181",2013,1181,"Y02",2,2,0
"2014_1181",2014,1181,"Y03",3,2,-1
"2015_1181",2015,1181,"X01",1,3,2
"2016_1181",2016,1181,"Z04",4,1,-3
"2017_1181",2017,1181,"W02",2,4,2
"1992_1183",1992,1183,"X15",15,20,5
"2001_1183",2001,1183,"Y15",15,20,5
"2005_1184",2005,1184,"Y15",15,20,5
"2007_1184",2007,1184,"W16",16,20,4
"2014_1184",2014,1184,"X15",15,20,5
"1988_1185",1988,1185,"X15",15,20,5
"1991_1185",1991,1185,"W12",12,20,8
"1996_1185",1996,1185,"Y09",9,20,11
"1998_1185",1998,1185,"W13",13,20,7
"2004_1186",2004,1186,"Y15",15,20,5
"2015_1186",2015,1186,"X13",13,20,7
"1993_1187",1993,1187,"W16",16,20,4
"1989_1190",1989,1190,"Z16",16,20,4
"1990_1190",1990,1190,"Y13",13,16,3
"1991_1190",1991,1190,"Y10",10,13,3
"1992_1190",1992,1190,"Z14",14,10,-4
"2003_1190",2003,1190,"W15",15,20,5
"2004_1190",2004,1190,"W13",13,15,2
"2009_1190",2009,1190,"W16",16,20,4
"2010_1190",2010,1190,"W16",16,16,0
"2017_1190",2017,1190,"W13",13,20,7
"1989_1191",1989,1191,"X11",11,20,9
"1992_1191",1992,1191,"Y08",8,20,12
"1993_1191",1993,1191,"Y14",14,8,-6
"1999_1191",1999,1191,"X11",11,20,9
"1985_1192",1985,1192,"Z16",16,20,4
"1988_1192",1988,1192,"X16",16,20,4
"1998_1192",1998,1192,"W15",15,20,5
"2005_1192",2005,1192,"X16",16,20,4
"2016_1192",2016,1192,"W16a",16,20,4
"1986_1193",1986,1193,"Y13",13,20,7
"1987_1193",1987,1193,"Y16",16,13,-3
"1997_1193",1997,1193,"W16",16,20,4
"2002_1194",2002,1194,"Y15",15,20,5
"2013_1195",2013,1195,"X15",15,20,5
"2016_1195",2016,1195,"W16b",16,20,4
"2017_1195",2017,1195,"X14",14,16,2
"1987_1196",1987,1196,"W06",6,20,14
"1988_1196",1988,1196,"Z06",6,6,0
"1989_1196",1989,1196,"Y07",7,6,-1
"1994_1196",1994,1196,"W03",3,20,17
"1995_1196",1995,1196,"Z10",10,3,-7
"1999_1196",1999,1196,"Z06",6,20,14
"2000_1196",2000,1196,"W05",5,6,1
"2001_1196",2001,1196,"Z03",3,5,2
"2002_1196",2002,1196,"X05",5,3,-2
"2003_1196",2003,1196,"X02",2,5,3
"2004_1196",2004,1196,"Y05",5,2,-3
"2005_1196",2005,1196,"Z04",4,5,1
"2006_1196",2006,1196,"Y03",3,4,1
"2007_1196",2007,1196,"Y01",1,3,2
"2010_1196",2010,1196,"Z10",10,20,10
"2011_1196",2011,1196,"Y02",2,10,8
"2012_1196",2012,1196,"Z07",7,2,-5
"2013_1196",2013,1196,"X03",3,7,4
"2014_1196",2014,1196,"X01",1,3,2
"2017_1196",2017,1196,"W04",4,20,16
"1999_1197",1999,1197,"W16",16,20,4
"2004_1197",2004,1197,"Z16a",16,20,4
"2007_1197",2007,1197,"Z16a",16,20,4
"1995_1198",1995,1198,"X16",16,20,4
"1988_1199",1988,1199,"Z12",12,20,8
"1989_1199",1989,1199,"Z04",4,12,8
"1991_1199",1991,1199,"X07",7,20,13
"1992_1199",1992,1199,"X03",3,7,4
"1993_1199",1993,1199,"Y03",3,3,0
"1998_1199",1998,1199,"Y12",12,20,8
"2009_1199",2009,1199,"W05",5,20,15
"2010_1199",2010,1199,"Z09",9,5,-4
"2011_1199",2011,1199,"Z10",10,9,-1
"2012_1199",2012,1199,"W03",3,10,7
"2017_1199",2017,1199,"X03",3,20,17
"1992_1200",1992,1200,"W14",14,20,6
"2000_1201",2000,1201,"Z09",9,20,11
"2001_1201",2001,1201,"Z09",9,9,0
"2016_1201",2016,1201,"X14",14,20,6
"1993_1203",1993,1203,"Z12",12,20,8
"1994_1203",1994,1203,"W10",10,12,2
"1996_1203",1996,1203,"Z11",11,20,9
"1998_1203",1998,1203,"Z09",9,20,11
"1999_1203",1999,1203,"Y11",11,9,-2
"2005_1203",2005,1203,"W12",12,20,8
"2006_1203",2006,1203,"W08",8,12,4
"2007_1203",2007,1203,"W11",11,8,-3
"2014_1203",2014,1203,"W09",9,20,11
"1987_1204",1987,1204,"W15",15,20,5
"1992_1204",1992,1204,"Z15",15,20,5
"1989_1206",1989,1206,"X15",15,20,5
"1999_1206",1999,1206,"W14",14,20,6
"2001_1206",2001,1206,"X14",14,20,6
"2006_1206",2006,1206,"Z11",11,20,9
"2008_1206",2008,1206,"W12",12,20,8
"2011_1206",2011,1206,"W08",8,20,12
"1985_1207",1985,1207,"W01",1,20,19
"1986_1207",1986,1207,"X04",4,1,-3
"1987_1207",1987,1207,"X01",1,4,3
"1988_1207",1988,1207,"W08",8,1,-7
"1989_1207",1989,1207,"W01",1,8,7
"1990_1207",1990,1207,"X03",3,1,-2
"1991_1207",1991,1207,"Z08",8,3,-5
"1992_1207",1992,1207,"X06",6,8,2
"1994_1207",1994,1207,"Y09",9,20,11
"1995_1207",1995,1207,"Z06",6,9,3
"1996_1207",1996,1207,"W02",2,6,4
"1997_1207",1997,1207,"Z10",10,2,-8
"2001_1207",2001,1207,"X10",10,20,10
"2006_1207",2006,1207,"Y07",7,20,13
"2007_1207",2007,1207,"W02",2,7,5
"2008_1207",2008,1207,"X02",2,2,0
"2010_1207",2010,1207,"Y03",3,20,17
"2011_1207",2011,1207,"Z06",6,3,-3
"2012_1207",2012,1207,"X03",3,6,3
"2013_1207",2013,1207,"X02",2,3,1
"2015_1207",2015,1207,"X04",4,20,16
"1985_1208",1985,1208,"W06",6,20,14
"1987_1208",1987,1208,"Z08",8,20,12
"1990_1208",1990,1208,"X07",7,20,13
"1991_1208",1991,1208,"X11",11,7,-4
"1996_1208",1996,1208,"Z08",8,20,12
"1997_1208",1997,1208,"X03",3,8,5
"2001_1208",2001,1208,"W08",8,20,12
"2002_1208",2002,1208,"W03",3,8,5
"2008_1208",2008,1208,"Z14",14,20,6
"2011_1208",2011,1208,"W10",10,20,10
"2015_1208",2015,1208,"W10",10,20,10
"1991_1209",1991,1209,"X16",16,20,4
"2001_1209",2001,1209,"X11",11,20,9
"2015_1209",2015,1209,"Z14",14,20,6
"1985_1210",1985,1210,"W02",2,20,18
"1986_1210",1986,1210,"Y02",2,2,0
"1987_1210",1987,1210,"Y07",7,2,-5
"1988_1210",1988,1210,"W05",5,7,2
"1989_1210",1989,1210,"Y06",6,5,-1
"1990_1210",1990,1210,"Y04",4,6,2
"1991_1210",1991,1210,"Y08",8,4,-4
"1992_1210",1992,1210,"Y07",7,8,1
"1993_1210",1993,1210,"Z04",4,7,3
"1996_1210",1996,1210,"Y03",3,20,17
"2001_1210",2001,1210,"X08",8,20,12
"2004_1210",2004,1210,"Z03",3,20,17
"2005_1210",2005,1210,"W05",5,3,-2
"2007_1210",2007,1210,"Y10",10,20,10
"2010_1210",2010,1210,"Y10",10,20,10
"1995_1211",1995,1211,"X14",14,20,6
"1999_1211",1999,1211,"Z10",10,20,10
"2000_1211",2000,1211,"Z10",10,10,0
"2001_1211",2001,1211,"Z12",12,10,-2
"2002_1211",2002,1211,"Z06",6,12,6
"2003_1211",2003,1211,"Z09",9,6,-3
"2004_1211",2004,1211,"Z02",2,9,7
"2005_1211",2005,1211,"W03",3,2,-1
"2006_1211",2006,1211,"X03",3,3,0
"2007_1211",2007,1211,"Z10",10,3,-7
"2008_1211",2008,1211,"X07",7,10,3
"2009_1211",2009,1211,"X04",4,7,3
"2010_1211",2010,1211,"Z08",8,4,-4
"2011_1211",2011,1211,"Y11",11,8,-3
"2012_1211",2012,1211,"W07",7,11,4
"2013_1211",2013,1211,"Z01",1,7,6
"2014_1211",2014,1211,"Z08",8,1,-7
"2015_1211",2015,1211,"X02",2,8,6
"2016_1211",2016,1211,"X11",11,2,-9
"2017_1211",2017,1211,"X01",1,11,10
"2001_1214",2001,1214,"X15",15,20,5
"2002_1214",2002,1214,"W15",15,15,0
"2006_1214",2006,1214,"Y16a",16,20,4
"2011_1214",2011,1214,"X16",16,20,4
"2015_1214",2015,1214,"Y16a",16,20,4
"2016_1214",2016,1214,"X16",16,16,0
"2012_1217",2012,1217,"W12",12,20,8
"2013_1217",2013,1217,"Z14",14,12,-2
"2014_1217",2014,1217,"W12",12,14,2
"2015_1217",2015,1217,"Z13",13,12,-1
"1994_1218",1994,1218,"Z13",13,20,7
"2001_1218",2001,1218,"Y12",12,20,8
"2002_1218",2002,1218,"Z10",10,12,2
"2016_1218",2016,1218,"Y13",13,20,7
"2000_1220",2000,1220,"W14",14,20,6
"2001_1220",2001,1220,"W13",13,14,1
"1993_1221",1993,1221,"W13",13,20,7
"2001_1221",2001,1221,"W15",15,20,5
"2002_1221",2002,1221,"X16",16,15,-1
"2003_1221",2003,1221,"Y14",14,16,2
"2007_1221",2007,1221,"Z13",13,20,7
"2016_1221",2016,1221,"Z16a",16,20,4
"1987_1222",1987,1222,"X12",12,20,8
"1990_1222",1990,1222,"Y08",8,20,12
"1992_1222",1992,1222,"Y10",10,20,10
"2010_1222",2010,1222,"Y13",13,20,7
"1992_1224",1992,1224,"Y16",16,20,4
"1989_1225",1989,1225,"X13",13,20,7
"1990_1225",1990,1225,"Z13",13,13,0
"1987_1226",1987,1226,"Z16",16,20,4
"1998_1227",1998,1227,"W09",9,20,11
"2002_1227",2002,1227,"Z15",15,20,5
"2004_1227",2004,1227,"Z13",13,20,7
"1985_1228",1985,1228,"W03",3,20,17
"1986_1228",1986,1228,"Y04",4,3,-1
"1987_1228",1987,1228,"X03",3,4,1
"1988_1228",1988,1228,"Y03",3,3,0
"1989_1228",1989,1228,"Y01",1,3,2
"1990_1228",1990,1228,"X05",5,1,-4
"1993_1228",1993,1228,"Z06",6,20,14
"1994_1228",1994,1228,"Y08",8,6,-2
"1995_1228",1995,1228,"W11",11,8,-3
"1997_1228",1997,1228,"X06",6,20,14
"1998_1228",1998,1228,"X05",5,6,1
"2000_1228",2000,1228,"W04",4,20,16
"2001_1228",2001,1228,"Y01",1,4,3
"2002_1228",2002,1228,"X04",4,1,-3
"2003_1228",2003,1228,"Z04",4,4,0
"2004_1228",2004,1228,"W05",5,4,-1
"2005_1228",2005,1228,"X01",1,5,4
"2006_1228",2006,1228,"Z04",4,1,-3
"2007_1228",2007,1228,"Z12",12,4,-8
"2009_1228",2009,1228,"X05",5,20,15
"2011_1228",2011,1228,"Z09",9,20,11
"2013_1228",2013,1228,"W07",7,20,13
"1985_1229",1985,1229,"Y09",9,20,11
"1990_1229",1990,1229,"Z14",14,20,6
"1997_1229",1997,1229,"Y11",11,20,9
"1998_1229",1998,1229,"X09",9,11,2
"1986_1231",1986,1231,"W03",3,20,17
"1987_1231",1987,1231,"Y01",1,3,2
"1988_1231",1988,1231,"W04",4,1,-3
"1989_1231",1989,1231,"X02",2,4,2
"1990_1231",1990,1231,"W08",8,2,-6
"1991_1231",1991,1231,"X02",2,8,6
"1992_1231",1992,1231,"X02",2,2,0
"1993_1231",1993,1231,"X01",1,2,1
"1994_1231",1994,1231,"W05",5,1,-4
"1995_1231",1995,1231,"X09",9,5,-4
"1996_1231",1996,1231,"Y06",6,9,3
"1997_1231",1997,1231,"W08",8,6,-2
"1998_1231",1998,1231,"W07",7,8,1
"1999_1231",1999,1231,"Y06",6,7,1
"2000_1231",2000,1231,"W06",6,6,0
"2001_1231",2001,1231,"X04",4,6,2
"2002_1231",2002,1231,"Y05",5,4,-1
"2003_1231",2003,1231,"Y07",7,5,-2
"2006_1231",2006,1231,"X06",6,20,14
"2007_1231",2007,1231,"Z07",7,6,-1
"2008_1231",2008,1231,"W08",8,7,-1
"2012_1231",2012,1231,"Y04",4,20,16
"2013_1231",2013,1231,"W01",1,4,3
"2015_1231",2015,1231,"Y10",10,20,10
"2016_1231",2016,1231,"W05",5,10,5
"2000_1232",2000,1232,"Z12",12,20,8
"2001_1232",2001,1232,"Z13",13,12,-1
"2011_1232",2011,1232,"W14",14,20,6
"1985_1233",1985,1233,"W13",13,20,7
"1998_1233",1998,1233,"Z12",12,20,8
"2000_1233",2000,1233,"Y14",14,20,6
"2001_1233",2001,1233,"Y14",14,14,0
"2006_1233",2006,1233,"W13",13,20,7
"2012_1233",2012,1233,"Z14b",14,20,6
"2013_1233",2013,1233,"Z15",15,14,-1
"2016_1233",2016,1233,"X13",13,20,7
"2017_1233",2017,1233,"Y14",14,13,-1
"1985_1234",1985,1234,"X08",8,20,12
"1986_1234",1986,1234,"X11",11,8,-3
"1987_1234",1987,1234,"Z02",2,11,9
"1988_1234",1988,1234,"Z05",5,2,-3
"1989_1234",1989,1234,"W04",4,5,1
"1991_1234",1991,1234,"Y07",7,20,13
"1992_1234",1992,1234,"W09",9,7,-2
"1993_1234",1993,1234,"Y04",4,9,5
"1996_1234",1996,1234,"Z06",6,20,14
"1997_1234",1997,1234,"Z08",8,6,-2
"1999_1234",1999,1234,"Z05",5,20,15
"2001_1234",2001,1234,"W07",7,20,13
"2005_1234",2005,1234,"Y10",10,20,10
"2006_1234",2006,1234,"W03",3,10,7
"2014_1234",2014,1234,"Y11a",11,20,9
"2015_1234",2015,1234,"X07",7,11,4
"2016_1234",2016,1234,"Y07",7,7,0
"1985_1235",1985,1235,"Y13",13,20,7
"1986_1235",1986,1235,"X07",7,13,6
"1988_1235",1988,1235,"W12",12,20,8
"1989_1235",1989,1235,"Z10",10,12,2
"1992_1235",1992,1235,"W10",10,20,10
"1993_1235",1993,1235,"Z08",8,10,2
"1995_1235",1995,1235,"Z07",7,20,13
"1996_1235",1996,1235,"X05",5,7,2
"1997_1235",1997,1235,"Y06",6,5,-1
"2000_1235",2000,1235,"Y02",2,20,18
"2001_1235",2001,1235,"X02",2,2,0
"2005_1235",2005,1235,"Z09",9,20,11
"2012_1235",2012,1235,"Y08",8,20,12
"2013_1235",2013,1235,"Z10",10,8,-2
"2014_1235",2014,1235,"W03",3,10,7
"2015_1235",2015,1235,"X03",3,3,0
"2016_1235",2016,1235,"X04",4,3,-1
"2017_1235",2017,1235,"Y05",5,4,-1
"2003_1237",2003,1237,"Y16",16,20,4
"1997_1238",1997,1238,"X16",16,20,4
"2000_1238",2000,1238,"Z16",16,20,4
"2007_1238",2007,1238,"Y16",16,20,4
"1986_1239",1986,1239,"X08",8,20,12
"2017_1240",2017,1240,"Y15",15,20,5
"1994_1241",1994,1241,"W14",14,20,6
"2013_1241",2013,1241,"W16a",16,20,4
"1985_1242",1985,1242,"Z03",3,20,17
"1986_1242",1986,1242,"X01",1,3,2
"1987_1242",1987,1242,"X05",5,1,-4
"1988_1242",1988,1242,"X06",6,5,-1
"1990_1242",1990,1242,"W02",2,20,18
"1991_1242",1991,1242,"X03",3,2,-1
"1992_1242",1992,1242,"Y01",1,3,2
"1993_1242",1993,1242,"X02",2,1,-1
"1994_1242",1994,1242,"X04",4,2,-2
"1995_1242",1995,1242,"Y01",1,4,3
"1996_1242",1996,1242,"Z02",2,1,-1
"1997_1242",1997,1242,"X01",1,2,1
"1998_1242",1998,1242,"Y01",1,1,0
"1999_1242",1999,1242,"X06",6,1,-5
"2000_1242",2000,1242,"W08",8,6,-2
"2001_1242",2001,1242,"Y04",4,8,4
"2002_1242",2002,1242,"X01",1,4,3
"2003_1242",2003,1242,"Z02",2,1,-1
"2004_1242",2004,1242,"Z04",4,2,-2
"2005_1242",2005,1242,"Z03",3,4,1
"2006_1242",2006,1242,"X04",4,3,-1
"2007_1242",2007,1242,"Z01",1,4,3
"2008_1242",2008,1242,"X01",1,1,0
"2009_1242",2009,1242,"Y03",3,1,-2
"2010_1242",2010,1242,"Y01",1,3,2
"2011_1242",2011,1242,"Z01",1,1,0
"2012_1242",2012,1242,"X02",2,1,-1
"2013_1242",2013,1242,"X01",1,2,1
"2014_1242",2014,1242,"X02",2,1,-1
"2015_1242",2015,1242,"Y02",2,2,0
"2016_1242",2016,1242,"Y01",1,2,1
"2017_1242",2017,1242,"Y01",1,1,0
"1987_1243",1987,1243,"Z09",9,20,11
"1988_1243",1988,1243,"X04",4,9,5
"1989_1243",1989,1243,"W06",6,4,-2
"1990_1243",1990,1243,"X11",11,6,-5
"1993_1243",1993,1243,"Y06",6,20,14
"1996_1243",1996,1243,"W10",10,20,10
"2008_1243",2008,1243,"X11",11,20,9
"2010_1243",2010,1243,"Z02",2,20,18
"2011_1243",2011,1243,"Y05",5,2,-3
"2012_1243",2012,1243,"W08",8,5,-3
"2013_1243",2013,1243,"Z04",4,8,4
"2014_1243",2014,1243,"Y09",9,4,-5
"2017_1243",2017,1243,"Z11a",11,20,9
"1999_1245",1999,1245,"W11",11,20,9
"2001_1245",2001,1245,"X13",13,20,7
"2002_1245",2002,1245,"Y10",10,13,3
"2006_1245",2006,1245,"X12",12,20,8
"2008_1245",2008,1245,"X09",9,20,11
"2017_1245",2017,1245,"Z14",14,20,6
"1985_1246",1985,1246,"X12",12,20,8
"1986_1246",1986,1246,"Y01",1,12,11
"1987_1246",1987,1246,"X08",8,1,-7
"1988_1246",1988,1246,"Y02",2,8,6
"1992_1246",1992,1246,"W02",2,20,18
"1993_1246",1993,1246,"Y01",1,2,1
"1994_1246",1994,1246,"X03",3,1,-2
"1995_1246",1995,1246,"Z01",1,3,2
"1996_1246",1996,1246,"X01",1,1,0
"1997_1246",1997,1246,"Z01",1,1,0
"1998_1246",1998,1246,"Z02",2,1,-1
"1999_1246",1999,1246,"X03",3,2,-1
"2000_1246",2000,1246,"Y05",5,3,-2
"2001_1246",2001,1246,"W02",2,5,3
"2002_1246",2002,1246,"W04",4,2,-2
"2003_1246",2003,1246,"Y01",1,4,3
"2004_1246",2004,1246,"Z01",1,1,0
"2005_1246",2005,1246,"Y02",2,1,-1
"2006_1246",2006,1246,"Z08",8,2,-6
"2007_1246",2007,1246,"Z08",8,8,0
"2008_1246",2008,1246,"Y11",11,8,-3
"2010_1246",2010,1246,"W01",1,20,19
"2011_1246",2011,1246,"W04",4,1,-3
"2012_1246",2012,1246,"Y01",1,4,3
"2014_1246",2014,1246,"Y08",8,20,12
"2015_1246",2015,1246,"Y01",1,8,7
"2016_1246",2016,1246,"W04",4,1,-3
"2017_1246",2017,1246,"Z02",2,4,2
"1988_1247",1988,1247,"X13",13,20,7
"1989_1247",1989,1247,"Z08",8,13,5
"1990_1247",1990,1247,"W04",4,8,4
"1992_1247",1992,1247,"W13",13,20,7
"2013_1247",2013,1247,"Z13b",13,20,7
"1999_1248",1999,1248,"W15",15,20,5
"2000_1248",2000,1248,"W15",15,15,0
"2015_1248",2015,1248,"W16",16,20,4
"2000_1249",2000,1249,"W16",16,20,4
"2012_1249",2012,1249,"X16a",16,20,4
"1985_1250",1985,1250,"W16",16,20,4
"1988_1250",1988,1250,"W16",16,20,4
"2004_1250",2004,1250,"Z16b",16,20,4
"2010_1250",2010,1250,"Y16",16,20,4
"2012_1250",2012,1250,"Y15",15,20,5
"1994_1251",1994,1251,"W16",16,20,4
"2004_1251",2004,1251,"Y16",16,20,4
"2013_1251",2013,1251,"Y16a",16,20,4
"1993_1253",1993,1253,"Z11",11,20,9
"1995_1253",1995,1253,"X13",13,20,7
"2007_1253",2007,1253,"X12",12,20,8
"2012_1253",2012,1253,"Z12",12,20,8
"1997_1254",1997,1254,"W13",13,20,7
"2011_1254",2011,1254,"W15",15,20,5
"2012_1254",2012,1254,"Z16",16,15,-1
"2013_1254",2013,1254,"W16b",16,16,0
"1985_1256",1985,1256,"Y05",5,20,15
"1987_1256",1987,1256,"Y14",14,20,6
"1989_1256",1989,1256,"Z09",9,20,11
"1991_1256",1991,1256,"X12",12,20,8
"1986_1257",1986,1257,"Z02",2,20,18
"1988_1257",1988,1257,"Y05",5,20,15
"1989_1257",1989,1257,"Y04",4,5,1
"1990_1257",1990,1257,"Z04",4,4,0
"1992_1257",1992,1257,"X08",8,20,12
"1993_1257",1993,1257,"X04",4,8,4
"1994_1257",1994,1257,"Z03",3,4,1
"1995_1257",1995,1257,"Y11",11,3,-8
"1996_1257",1996,1257,"X06",6,11,5
"1997_1257",1997,1257,"W06",6,6,0
"1999_1257",1999,1257,"Y07",7,20,13
"2000_1257",2000,1257,"Z07",7,7,0
"2003_1257",2003,1257,"W04",4,20,16
"2004_1257",2004,1257,"W10",10,4,-6
"2005_1257",2005,1257,"W04",4,10,6
"2007_1257",2007,1257,"X06",6,20,14
"2008_1257",2008,1257,"W03",3,6,3
"2009_1257",2009,1257,"Y01",1,3,2
"2010_1257",2010,1257,"X09",9,1,-8
"2011_1257",2011,1257,"Z04",4,9,5
"2012_1257",2012,1257,"Z04",4,4,0
"2013_1257",2013,1257,"Y01",1,4,3
"2014_1257",2014,1257,"Y04",4,1,-3
"2015_1257",2015,1257,"W04",4,4,0
"2017_1257",2017,1257,"Y02",2,20,18
"1988_1258",1988,1258,"Z10",10,20,10
"1989_1258",1989,1258,"Y12",12,10,-2
"1990_1258",1990,1258,"Z11",11,12,1
"1994_1259",1994,1259,"Z15",15,20,5
"2012_1259",2012,1259,"W15",15,20,5
"1985_1260",1985,1260,"W04",4,20,16
"1985_1261",1985,1261,"Z04",4,20,16
"1986_1261",1986,1261,"Y11",11,4,-7
"1987_1261",1987,1261,"Y10",10,11,1
"1988_1261",1988,1261,"W09",9,10,1
"1989_1261",1989,1261,"X10",10,9,-1
"1990_1261",1990,1261,"Y05",5,10,5
"1991_1261",1991,1261,"Y06",6,5,-1
"1992_1261",1992,1261,"X07",7,6,-1
"1993_1261",1993,1261,"X11",11,7,-4
"2000_1261",2000,1261,"Z04",4,20,16
"2003_1261",2003,1261,"X08",8,20,12
"2005_1261",2005,1261,"X06",6,20,14
"2006_1261",2006,1261,"W04",4,6,2
"2009_1261",2009,1261,"X08",8,20,12
"2015_1261",2015,1261,"W09",9,20,11
"1993_1264",1993,1264,"W11",11,20,9
"1995_1264",1995,1264,"Z13",13,20,7
"2003_1264",2003,1264,"W14",14,20,6
"2004_1264",2004,1264,"Y12",12,14,2
"2014_1264",2014,1264,"Y13",13,20,7
"2015_1264",2015,1264,"Y16b",16,13,-3
"1986_1265",1986,1265,"Y15",15,20,5
"1987_1265",1987,1265,"Z14",14,15,1
"1993_1266",1993,1266,"X12",12,20,8
"1994_1266",1994,1266,"X06",6,12,6
"1996_1266",1996,1266,"W04",4,20,16
"1997_1266",1997,1266,"X07",7,4,-3
"2002_1266",2002,1266,"W05",5,20,15
"2003_1266",2003,1266,"Y03",3,5,2
"2006_1266",2006,1266,"X07",7,20,13
"2007_1266",2007,1266,"W08",8,7,-1
"2008_1266",2008,1266,"Y06",6,8,2
"2009_1266",2009,1266,"Z06",6,6,0
"2010_1266",2010,1266,"W06",6,6,0
"2011_1266",2011,1266,"W11",11,6,-5
"2012_1266",2012,1266,"Z03",3,11,8
"2013_1266",2013,1266,"W03",3,3,0
"2017_1266",2017,1266,"W10",10,20,10
"1985_1267",1985,1267,"X15",15,20,5
"1987_1267",1987,1267,"W13",13,20,7
"1985_1268",1985,1268,"Z05",5,20,15
"1986_1268",1986,1268,"Z05",5,5,0
"1988_1268",1988,1268,"Y07",7,20,13
"1994_1268",1994,1268,"Y10",10,20,10
"1995_1268",1995,1268,"X03",3,10,7
"1996_1268",1996,1268,"Z07",7,3,-4
"1997_1268",1997,1268,"X05",5,7,2
"1998_1268",1998,1268,"X04",4,5,1
"1999_1268",1999,1268,"Y02",2,4,2
"2000_1268",2000,1268,"Y03",3,2,-1
"2001_1268",2001,1268,"X03",3,3,0
"2002_1268",2002,1268,"W01",1,3,2
"2003_1268",2003,1268,"X06",6,1,-5
"2004_1268",2004,1268,"X04",4,6,2
"2007_1268",2007,1268,"Y04",4,20,16
"2009_1268",2009,1268,"Z10",10,20,10
"2010_1268",2010,1268,"Y04",4,10,6
"2015_1268",2015,1268,"Y04",4,20,16
"2016_1268",2016,1268,"Y05",5,4,-1
"2017_1268",2017,1268,"X06",6,5,-1
"1992_1269",1992,1269,"W03",3,20,17
"1993_1269",1993,1269,"W03",3,3,0
"1994_1269",1994,1269,"Y02",2,3,1
"1995_1269",1995,1269,"W02",2,2,0
"1996_1269",1996,1269,"W01",1,2,1
"1997_1269",1997,1269,"W11",11,1,-10
"1998_1269",1998,1269,"Z07",7,11,4
"2014_1269",2014,1269,"Y06",6,20,14
"1989_1270",1989,1270,"Y16",16,20,4
"2002_1270",2002,1270,"X14",14,20,6
"1985_1272",1985,1272,"Y02",2,20,18
"1986_1272",1986,1272,"Y03",3,2,-1
"1988_1272",1988,1272,"X09",9,20,11
"1989_1272",1989,1272,"X05",5,9,4
"1992_1272",1992,1272,"Y06",6,20,14
"1993_1272",1993,1272,"Y10",10,6,-4
"1995_1272",1995,1272,"Y06",6,20,14
"1996_1272",1996,1272,"Z05",5,6,1
"2003_1272",2003,1272,"Z07",7,20,13
"2004_1272",2004,1272,"Y07",7,7,0
"2006_1272",2006,1272,"X01",1,20,19
"2007_1272",2007,1272,"X02",2,1,-1
"2008_1272",2008,1272,"Y01",1,2,1
"2009_1272",2009,1272,"Z02",2,1,-1
"2011_1272",2011,1272,"X12",12,20,8
"2012_1272",2012,1272,"Z08",8,12,4
"2013_1272",2013,1272,"Y06",6,8,2
"2014_1272",2014,1272,"W08",8,6,-2
"1985_1273",1985,1273,"W15",15,20,5
"2014_1273",2014,1273,"Y14",14,20,6
"1998_1274",1998,1274,"Z11",11,20,9
"1999_1274",1999,1274,"W02",2,11,9
"2000_1274",2000,1274,"X06",6,2,-4
"2002_1274",2002,1274,"Z05",5,20,15
"2008_1274",2008,1274,"Y07",7,20,13
"2013_1274",2013,1274,"W02",2,20,18
"2016_1274",2016,1274,"Y03",3,20,17
"2017_1274",2017,1274,"Y08",8,3,-5
"1985_1275",1985,1275,"Z12",12,20,8
"1986_1275",1986,1275,"X10",10,12,2
"1992_1275",1992,1275,"Z13",13,20,7
"1995_1275",1995,1275,"Y12",12,20,8
"1997_1275",1997,1275,"Y13",13,20,7
"1999_1275",1999,1275,"X10",10,20,10
"2007_1275",2007,1275,"Y14",14,20,6
"1985_1276",1985,1276,"Z01",1,20,19
"1986_1276",1986,1276,"X02",2,1,-1
"1987_1276",1987,1276,"W09",9,2,-7
"1988_1276",1988,1276,"Z03",3,9,6
"1989_1276",1989,1276,"Z03",3,3,0
"1990_1276",1990,1276,"Z03",3,3,0
"1992_1276",1992,1276,"Z06",6,20,14
"1993_1276",1993,1276,"Z01",1,6,5
"1994_1276",1994,1276,"Y03",3,1,-2
"1995_1276",1995,1276,"Y09",9,3,-6
"1996_1276",1996,1276,"X07",7,9,2
"1998_1276",1998,1276,"Z03",3,20,17
"2009_1276",2009,1276,"X10",10,20,10
"2011_1276",2011,1276,"X08",8,20,12
"2012_1276",2012,1276,"X04",4,8,4
"2013_1276",2013,1276,"X04",4,4,0
"2014_1276",2014,1276,"Y02",2,4,2
"2016_1276",2016,1276,"W11a",11,20,9
"2017_1276",2017,1276,"Y07",7,11,4
"1985_1277",1985,1277,"Y10",10,20,10
"1986_1277",1986,1277,"X05",5,10,5
"1990_1277",1990,1277,"Y01",1,20,19
"1991_1277",1991,1277,"Z05",5,1,-4
"1992_1277",1992,1277,"Y05",5,5,0
"1994_1277",1994,1277,"X07",7,20,13
"1995_1277",1995,1277,"Z03",3,7,4
"1998_1277",1998,1277,"W04",4,20,16
"1999_1277",1999,1277,"X01",1,4,3
"2000_1277",2000,1277,"Y01",1,1,0
"2001_1277",2001,1277,"Z01",1,1,0
"2002_1277",2002,1277,"W10",10,1,-9
"2003_1277",2003,1277,"X07",7,10,3
"2004_1277",2004,1277,"Z07",7,7,0
"2005_1277",2005,1277,"Y05",5,7,2
"2006_1277",2006,1277,"Z06",6,5,-1
"2007_1277",2007,1277,"W09",9,6,-3
"2008_1277",2008,1277,"Y05",5,9,4
"2009_1277",2009,1277,"Y02",2,5,3
"2010_1277",2010,1277,"Y05",5,2,-3
"2011_1277",2011,1277,"Y10",10,5,-5
"2012_1277",2012,1277,"Z01",1,10,9
"2013_1277",2013,1277,"Y03",3,1,-2
"2014_1277",2014,1277,"W04",4,3,-1
"2015_1277",2015,1277,"W07",7,4,-3
"2016_1277",2016,1277,"X02",2,7,5
"2017_1277",2017,1277,"Y09",9,2,-7
"1989_1278",1989,1278,"W11",11,20,9
"1990_1278",1990,1278,"Y06",6,11,5
"1994_1278",1994,1278,"Z06",6,20,14
"1995_1278",1995,1278,"W08",8,6,-2
"1997_1278",1997,1278,"Y01",1,20,19
"1999_1278",1999,1278,"Z07",7,20,13
"2005_1278",2005,1278,"Z08",8,20,12
"2009_1278",2009,1278,"W10",10,20,10
"2010_1278",2010,1278,"Z11",11,10,-1
"2013_1278",2013,1278,"X11",11,20,9
"2017_1278",2017,1278,"Z05",5,20,15
"1997_1279",1997,1279,"Y08",8,20,12
"1998_1279",1998,1279,"Y04",4,8,4
"1999_1279",1999,1279,"X09",9,4,-5
"2001_1279",2001,1279,"Y03",3,20,17
"2002_1279",2002,1279,"Z09",9,3,-6
"2013_1279",2013,1279,"Z12",12,20,8
"2015_1279",2015,1279,"Z11b",11,20,9
"1991_1280",1991,1280,"W05",5,20,15
"1995_1280",1995,1280,"X05",5,20,15
"1996_1280",1996,1280,"Y05",5,5,0
"2002_1280",2002,1280,"X03",3,20,17
"2003_1280",2003,1280,"W05",5,3,-2
"2004_1280",2004,1280,"W02",2,5,3
"2005_1280",2005,1280,"Y09",9,2,-7
"2008_1280",2008,1280,"Y08",8,20,12
"2009_1280",2009,1280,"Z13",13,8,-5
"1986_1281",1986,1281,"Z11",11,20,9
"1987_1281",1987,1281,"Y04",4,11,7
"1988_1281",1988,1281,"W06",6,4,-2
"1989_1281",1989,1281,"Y03",3,6,3
"1990_1281",1990,1281,"Y03",3,3,0
"1992_1281",1992,1281,"W05",5,20,15
"1993_1281",1993,1281,"Z10",10,5,-5
"1994_1281",1994,1281,"Z01",1,10,9
"1995_1281",1995,1281,"X08",8,1,-7
"1999_1281",1999,1281,"Z08",8,20,12
"2000_1281",2000,1281,"X09",9,8,-1
"2001_1281",2001,1281,"W09",9,9,0
"2002_1281",2002,1281,"Z12",12,9,-3
"2003_1281",2003,1281,"Y06",6,12,6
"2009_1281",2009,1281,"Z03",3,20,17
"2010_1281",2010,1281,"W10",10,3,-7
"2011_1281",2011,1281,"X11",11,10,-1
"2012_1281",2012,1281,"Z02",2,11,9
"2013_1281",2013,1281,"Y09",9,2,-7
"1987_1283",1987,1283,"X13",13,20,7
"1988_1283",1988,1283,"Z13",13,13,0
"1989_1283",1989,1283,"X14",14,13,-1
"1990_1283",1990,1283,"X09",9,14,5
"1992_1283",1992,1283,"Y12",12,20,8
"1999_1283",1999,1283,"W12",12,20,8
"1996_1284",1996,1284,"W13",13,20,7
"2001_1284",2001,1284,"W16",16,20,4
"2004_1284",2004,1284,"W15",15,20,5
"2006_1284",2006,1284,"Y16b",16,20,4
"1991_1285",1991,1285,"Z16",16,20,4
"1992_1285",1992,1285,"X14",14,16,2
"1997_1285",1997,1285,"Z16",16,20,4
"2002_1285",2002,1285,"X15",15,20,5
"2005_1285",2005,1285,"W16",16,20,4
"2006_1285",2006,1285,"Y12",12,16,4
"2010_1285",2010,1285,"W14",14,20,6
"2012_1285",2012,1285,"W13",13,20,7
"2013_1285",2013,1285,"W13",13,13,0
"1986_1286",1986,1286,"Z16",16,20,4
"1996_1286",1996,1286,"Z13",13,20,7
"2009_1287",2009,1287,"Y16b",16,20,4
"2011_1287",2011,1287,"Z13",13,20,7
"2009_1288",2009,1288,"X15",15,20,5
"2010_1288",2010,1288,"W15",15,15,0
"1986_1290",1986,1290,"W16",16,20,4
"1992_1290",1992,1290,"Z16",16,20,4
"1996_1290",1996,1290,"W15",15,20,5
"2008_1290",2008,1290,"Z16",16,20,4
"2012_1290",2012,1290,"Y16a",16,20,4
"1995_1291",1995,1291,"Z16",16,20,4
"1999_1291",1999,1291,"X16",16,20,4
"2008_1291",2008,1291,"W16b",16,20,4
"2014_1291",2014,1291,"X16b",16,20,4
"2017_1291",2017,1291,"W16a",16,20,4
"1985_1292",1985,1292,"Z15",15,20,5
"1987_1292",1987,1292,"W12",12,20,8
"1989_1292",1989,1292,"Z13",13,20,7
"2013_1292",2013,1292,"Y11a",11,20,9
"2016_1292",2016,1292,"X15",15,20,5
"2017_1292",2017,1292,"Z12",12,15,3
"1988_1293",1988,1293,"X14",14,20,6
"1990_1293",1990,1293,"Y16",16,20,4
"1991_1293",1991,1293,"X13",13,16,3
"1992_1293",1992,1293,"Y14",14,13,-1
"1995_1293",1995,1293,"Z15",15,20,5
"1997_1293",1997,1293,"X15",15,20,5
"1998_1293",1998,1293,"Y09",9,15,6
"1999_1293",1999,1293,"Y13",13,9,-4
"2002_1293",2002,1293,"W14",14,20,6
"2004_1293",2004,1293,"W12",12,20,8
"2006_1293",2006,1293,"Z14",14,20,6
"2010_1293",2010,1293,"Z13",13,20,7
"2012_1293",2012,1293,"Z06",6,20,14
"2011_1294",2011,1294,"X15",15,20,5
"2009_1295",2009,1295,"Y14",14,20,6
"2014_1295",2014,1295,"Z12",12,20,8
"2015_1295",2015,1295,"X15",15,12,-3
"1991_1296",1991,1296,"Y13",13,20,7
"1996_1296",1996,1296,"W14",14,20,6
"2017_1297",2017,1297,"Z15",15,20,5
"1985_1298",1985,1298,"Z13",13,20,7
"1986_1298",1986,1298,"W07",7,13,6
"1987_1298",1987,1298,"W08",8,7,-1
"1994_1298",1994,1298,"Z16",16,20,4
"1997_1298",1997,1298,"Z15",15,20,5
"1998_1298",1998,1298,"W16",16,15,-1
"1985_1299",1985,1299,"Y16",16,20,4
"1986_1299",1986,1299,"X16",16,16,0
"1987_1299",1987,1299,"X15",15,16,1
"1988_1299",1988,1299,"W14",14,15,1
"1994_1299",1994,1299,"Y16",16,20,4
"1995_1299",1995,1299,"W16",16,16,0
"2013_1299",2013,1299,"Y16b",16,20,4
"2014_1300",2014,1300,"W14",14,20,6
"2017_1300",2017,1300,"Y16a",16,20,4
"1985_1301",1985,1301,"X03",3,20,17
"1986_1301",1986,1301,"X06",6,3,-3
"1987_1301",1987,1301,"W11",11,6,-5
"1988_1301",1988,1301,"X03",3,11,8
"1989_1301",1989,1301,"W05",5,3,-2
"1991_1301",1991,1301,"W06",6,20,14
"2002_1301",2002,1301,"W07",7,20,13
"2003_1301",2003,1301,"W09",9,7,-2
"2004_1301",2004,1301,"X03",3,9,6
"2005_1301",2005,1301,"Z10",10,3,-7
"2006_1301",2006,1301,"W10",10,10,0
"2012_1301",2012,1301,"X11",11,20,9
"2013_1301",2013,1301,"W08",8,11,3
"2014_1301",2014,1301,"Y12a",12,8,-4
"2015_1301",2015,1301,"W08",8,12,4
"1986_1304",1986,1304,"Y09",9,20,11
"1991_1304",1991,1304,"Y03",3,20,17
"1992_1304",1992,1304,"Z08",8,3,-5
"1993_1304",1993,1304,"W10",10,8,-2
"1994_1304",1994,1304,"W06",6,10,4
"1998_1304",1998,1304,"X11",11,20,9
"2014_1304",2014,1304,"Z11",11,20,9
"1985_1305",1985,1305,"X14",14,20,6
"2004_1305",2004,1305,"Z10",10,20,10
"2005_1305",2005,1305,"X09",9,10,1
"2006_1305",2006,1305,"Y05",5,9,4
"2007_1305",2007,1305,"X07",7,5,-2
"2017_1305",2017,1305,"Y12",12,20,8
"1991_1307",1991,1307,"W14",14,20,6
"1993_1307",1993,1307,"Z05",5,20,15
"1994_1307",1994,1307,"Z10",10,5,-5
"1996_1307",1996,1307,"W07",7,20,13
"1997_1307",1997,1307,"W03",3,7,4
"1998_1307",1998,1307,"Z04",4,3,-1
"1999_1307",1999,1307,"Z09",9,4,-5
"2005_1307",2005,1307,"Z12",12,20,8
"2010_1307",2010,1307,"W03",3,20,17
"2012_1307",2012,1307,"Z05",5,20,15
"2013_1307",2013,1307,"Z03",3,5,2
"2014_1307",2014,1307,"X07",7,3,-4
"1990_1308",1990,1308,"Z06",6,20,14
"1991_1308",1991,1308,"Z06",6,6,0
"1992_1308",1992,1308,"X12",12,6,-6
"1993_1308",1993,1308,"W07",7,12,5
"1994_1308",1994,1308,"Y13",13,7,-6
"1999_1308",1999,1308,"X14",14,20,6
"2007_1308",2007,1308,"W13",13,20,7
"2010_1308",2010,1308,"Y12",12,20,8
"2012_1308",2012,1308,"Y13",13,20,7
"2013_1308",2013,1308,"Y13",13,13,0
"2014_1308",2014,1308,"Z13",13,13,0
"2015_1308",2015,1308,"Y15",15,13,-2
"2017_1308",2017,1308,"W14",14,20,6
"1987_1309",1987,1309,"X07",7,20,13
"1991_1309",1991,1309,"X14",14,20,6
"1993_1309",1993,1309,"X08",8,20,12
"1996_1309",1996,1309,"W11",11,20,9
"2017_1309",2017,1309,"W16b",16,20,4
"2005_1310",2005,1310,"Y14",14,20,6
"2007_1310",2007,1310,"Z16b",16,20,4
"1995_1311",1995,1311,"Y13",13,20,7
"1998_1311",1998,1311,"X16",16,20,4
"2012_1313",2012,1313,"Z15",15,20,5
"1985_1314",1985,1314,"Z02",2,20,18
"1986_1314",1986,1314,"Z03",3,2,-1
"1987_1314",1987,1314,"W01",1,3,2
"1988_1314",1988,1314,"Z02",2,1,-1
"1989_1314",1989,1314,"Z02",2,2,0
"1990_1314",1990,1314,"X08",8,2,-6
"1991_1314",1991,1314,"W01",1,8,7
"1992_1314",1992,1314,"Z04",4,1,-3
"1993_1314",1993,1314,"W01",1,4,3
"1994_1314",1994,1314,"W01",1,1,0
"1995_1314",1995,1314,"Z02",2,1,-1
"1996_1314",1996,1314,"W06",6,2,-4
"1997_1314",1997,1314,"W01",1,6,5
"1998_1314",1998,1314,"W01",1,1,0
"1999_1314",1999,1314,"Z03",3,1,-2
"2000_1314",2000,1314,"X08",8,3,-5
"2001_1314",2001,1314,"Z02",2,8,6
"2004_1314",2004,1314,"W06",6,20,14
"2005_1314",2005,1314,"Z01",1,6,5
"2006_1314",2006,1314,"Z03",3,1,-2
"2007_1314",2007,1314,"W01",1,3,2
"2008_1314",2008,1314,"W01",1,1,0
"2009_1314",2009,1314,"X01",1,1,0
"2011_1314",2011,1314,"W02",2,20,18
"2012_1314",2012,1314,"X01",1,2,1
"2013_1314",2013,1314,"X08",8,1,-7
"2014_1314",2014,1314,"W06",6,8,2
"2015_1314",2015,1314,"Z04",4,6,2
"2016_1314",2016,1314,"W01",1,4,3
"2017_1314",2017,1314,"Z01",1,1,0
"2017_1315",2017,1315,"X15",15,20,5
"2015_1316",2015,1316,"X16a",16,20,4
"1988_1317",1988,1317,"Z15",15,20,5
"2007_1317",2007,1317,"X15",15,20,5
"2010_1317",2010,1317,"Z15",15,20,5
"1985_1318",1985,1318,"W14",14,20,6
"1986_1318",1986,1318,"W13",13,14,1
"1987_1318",1987,1318,"W14",14,13,-1
"1991_1318",1991,1318,"W16",16,20,4
"2015_1318",2015,1318,"Y14",14,20,6
"1998_1319",1998,1319,"X15",15,20,5
"2000_1319",2000,1319,"Z15",15,20,5
"1990_1320",1990,1320,"Y14",14,20,6
"2004_1320",2004,1320,"Z14",14,20,6
"2005_1320",2005,1320,"Z11",11,14,3
"2006_1320",2006,1320,"Y10",10,11,1
"2009_1320",2009,1320,"Z12",12,20,8
"2010_1320",2010,1320,"Y09",9,12,3
"2015_1320",2015,1320,"W05",5,20,15
"2016_1320",2016,1320,"Z11",11,5,-6
"2017_1321",2017,1321,"X08",8,20,12
"2001_1322",2001,1322,"Y16a",16,20,4
"2006_1322",2006,1322,"W14",14,20,6
"2013_1322",2013,1322,"X14",14,20,6
"1985_1323",1985,1323,"Z07",7,20,13
"1986_1323",1986,1323,"X03",3,7,4
"1987_1323",1987,1323,"W05",5,3,-2
"1988_1323",1988,1323,"W10",10,5,-5
"1989_1323",1989,1323,"W09",9,10,1
"1990_1323",1990,1323,"Y10",10,9,-1
"2001_1323",2001,1323,"Y06",6,20,14
"2002_1323",2002,1323,"Y08",8,6,-2
"2003_1323",2003,1323,"Z05",5,8,3
"2007_1323",2007,1323,"Y06",6,20,14
"2008_1323",2008,1323,"W05",5,6,1
"2010_1323",2010,1323,"X06",6,20,14
"2011_1323",2011,1323,"Z02",2,6,4
"2012_1323",2012,1323,"Y07",7,2,-5
"2013_1323",2013,1323,"Z07",7,7,0
"2015_1323",2015,1323,"Y03",3,20,17
"2016_1323",2016,1323,"W06",6,3,-3
"2017_1323",2017,1323,"X05",5,6,1
"2005_1324",2005,1324,"Z16b",16,20,4
"2010_1324",2010,1324,"Z14",14,20,6
"2011_1324",2011,1324,"X13",13,14,1
"1985_1325",1985,1325,"Z14",14,20,6
"1994_1325",1994,1325,"W12",12,20,8
"2005_1325",2005,1325,"Z13",13,20,7
"2010_1325",2010,1325,"Y14",14,20,6
"2012_1325",2012,1325,"X13",13,20,7
"1985_1326",1985,1326,"Y04",4,20,16
"1987_1326",1987,1326,"X09",9,20,11
"1990_1326",1990,1326,"Z08",8,20,12
"1991_1326",1991,1326,"Y01",1,8,7
"1992_1326",1992,1326,"Z01",1,1,0
"1999_1326",1999,1326,"Y04",4,20,16
"2000_1326",2000,1326,"X03",3,4,1
"2001_1326",2001,1326,"W05",5,3,-2
"2002_1326",2002,1326,"Z04",4,5,1
"2006_1326",2006,1326,"Y02",2,20,18
"2007_1326",2007,1326,"X01",1,2,1
"2009_1326",2009,1326,"Y08",8,20,12
"2010_1326",2010,1326,"Y02",2,8,6
"2011_1326",2011,1326,"W01",1,2,1
"2012_1326",2012,1326,"W02",2,1,-1
"2013_1326",2013,1326,"Z02",2,2,0
"2014_1326",2014,1326,"X06",6,2,-4
"2015_1326",2015,1326,"Z10",10,6,-4
"1985_1328",1985,1328,"Y01",1,20,19
"1986_1328",1986,1328,"W04",4,1,-3
"1987_1328",1987,1328,"Z06",6,4,-2
"1988_1328",1988,1328,"Y01",1,6,5
"1989_1328",1989,1328,"Z01",1,1,0
"1990_1328",1990,1328,"X01",1,1,0
"1992_1328",1992,1328,"X04",4,20,16
"1995_1328",1995,1328,"Z04",4,20,16
"1996_1328",1996,1328,"Y10",10,4,-6
"1997_1328",1997,1328,"Z11",11,10,-1
"1998_1328",1998,1328,"W10",10,11,1
"1999_1328",1999,1328,"X13",13,10,-3
"2000_1328",2000,1328,"Z03",3,13,10
"2001_1328",2001,1328,"Z04",4,3,-1
"2002_1328",2002,1328,"Z02",2,4,2
"2003_1328",2003,1328,"W01",1,2,1
"2005_1328",2005,1328,"Y03",3,20,17
"2006_1328",2006,1328,"Y06",6,3,-3
"2008_1328",2008,1328,"W06",6,20,14
"2009_1328",2009,1328,"X02",2,6,4
"2013_1328",2013,1328,"X10",10,20,10
"2014_1328",2014,1328,"Z05",5,10,5
"2015_1328",2015,1328,"W03",3,5,2
"2016_1328",2016,1328,"Z02",2,3,1
"1991_1329",1991,1329,"W03",3,20,17
"1992_1329",1992,1329,"Z02",2,3,1
"1993_1329",1993,1329,"X05",5,2,-3
"1994_1329",1994,1329,"Y04",4,5,1
"1995_1329",1995,1329,"W04",4,4,0
"1998_1329",1998,1329,"Z08",8,20,12
"1999_1329",1999,1329,"Y09",9,8,-1
"2000_1329",2000,1329,"W03",3,9,6
"2001_1329",2001,1329,"W11",11,3,-8
"2002_1329",2002,1329,"Y07",7,11,4
"2003_1329",2003,1329,"W06",6,7,1
"2004_1329",2004,1329,"Y02",2,6,4
"2005_1329",2005,1329,"X02",2,2,0
"2009_1329",2009,1329,"W08",8,20,12
"2010_1329",2010,1329,"Y07",7,8,1
"2013_1329",2013,1329,"Y05",5,20,15
"2014_1329",2014,1329,"Z09",9,5,-4
"2015_1329",2015,1329,"Z09",9,9,0
"2017_1329",2017,1329,"Y10",10,20,10
"1985_1330",1985,1330,"W12",12,20,8
"1986_1330",1986,1330,"W08",8,12,4
"1992_1330",1992,1330,"W15",15,20,5
"1995_1330",1995,1330,"W14",14,20,6
"1997_1330",1997,1330,"W14",14,20,6
"2005_1330",2005,1330,"Y12",12,20,8
"2007_1330",2007,1330,"Y12",12,20,8
"2010_1330",2010,1330,"X11",11,20,9
"2011_1330",2011,1330,"Y09",9,11,2
"2006_1331",2006,1331,"X16",16,20,4
"2007_1331",2007,1331,"W14",14,16,2
"2008_1331",2008,1331,"Y13",13,14,1
"1995_1332",1995,1332,"X06",6,20,14
"2000_1332",2000,1332,"W07",7,20,13
"2002_1332",2002,1332,"X02",2,20,18
"2003_1332",2003,1332,"Y08",8,2,-6
"2007_1332",2007,1332,"Y03",3,20,17
"2008_1332",2008,1332,"Y09",9,3,-6
"2013_1332",2013,1332,"Y12",12,20,8
"2014_1332",2014,1332,"Z07",7,12,5
"2015_1332",2015,1332,"Z08",8,7,-1
"2016_1332",2016,1332,"Z01",1,8,7
"2017_1332",2017,1332,"Y03",3,1,-2
"1985_1333",1985,1333,"Z10",10,20,10
"1988_1333",1988,1333,"Y12",12,20,8
"1989_1333",1989,1333,"X06",6,12,6
"1990_1333",1990,1333,"Z05",5,6,1
"2016_1333",2016,1333,"Z07",7,20,13
"1997_1334",1997,1334,"Z13",13,20,7
"2004_1334",2004,1334,"Z12",12,20,8
"2005_1334",2005,1334,"W08",8,12,4
"2006_1334",2006,1334,"Y13",13,8,-5
"2013_1334",2013,1334,"W15",15,20,5
"1985_1335",1985,1335,"Y15",15,20,5
"1987_1335",1987,1335,"W16",16,20,4
"1993_1335",1993,1335,"W14",14,20,6
"1994_1335",1994,1335,"W11",11,14,3
"1995_1335",1995,1335,"W12",12,11,-1
"1999_1335",1999,1335,"Z11",11,20,9
"2000_1335",2000,1335,"W13",13,11,-2
"2002_1335",2002,1335,"Y11",11,20,9
"2003_1335",2003,1335,"W11",11,11,0
"2005_1335",2005,1335,"X13",13,20,7
"2006_1335",2006,1335,"W15",15,13,-2
"2007_1335",2007,1335,"X14",14,15,1
"1991_1336",1991,1336,"W13",13,20,7
"1996_1336",1996,1336,"W05",5,20,15
"2001_1336",2001,1336,"Z07",7,20,13
"2011_1336",2011,1336,"X10",10,20,10
"1985_1337",1985,1337,"Y14",14,20,6
"1986_1337",1986,1337,"Z12",12,14,2
"1991_1337",1991,1337,"Z14",14,20,6
"1992_1337",1992,1337,"Y11",11,14,3
"1994_1337",1994,1337,"Y14",14,20,6
"2000_1337",2000,1337,"W11",11,20,9
"2002_1337",2002,1337,"X10",10,20,10
"1985_1338",1985,1338,"Y12",12,20,8
"1987_1338",1987,1338,"Z03",3,20,17
"1988_1338",1988,1338,"X02",2,3,1
"1989_1338",1989,1338,"Y08",8,2,-6
"1991_1338",1991,1338,"X06",6,20,14
"1993_1338",1993,1338,"Y09",9,20,11
"2002_1338",2002,1338,"Y03",3,20,17
"2003_1338",2003,1338,"Y02",2,3,1
"2004_1338",2004,1338,"Y03",3,2,-1
"2005_1338",2005,1338,"W09",9,3,-6
"2006_1338",2006,1338,"X05",5,9,4
"2007_1338",2007,1338,"Z03",3,5,2
"2008_1338",2008,1338,"Y04",4,3,-1
"2009_1338",2009,1338,"W01",1,4,3
"2010_1338",2010,1338,"Z03",3,1,-2
"2011_1338",2011,1338,"Y01",1,3,2
"2013_1338",2013,1338,"Z08",8,20,12
"2014_1338",2014,1338,"X09",9,8,-1
"2016_1338",2016,1338,"W10",10,20,10
"1996_1339",1996,1339,"X14",14,20,6
"2008_1340",2008,1340,"X16",16,20,4
"2009_1340",2009,1340,"W13",13,16,3
"1998_1341",1998,1341,"Y16",16,20,4
"1989_1343",1989,1343,"W16",16,20,4
"1990_1343",1990,1343,"X13",13,16,3
"1991_1343",1991,1343,"W08",8,13,5
"1992_1343",1992,1343,"W11",11,8,-3
"1996_1343",1996,1343,"Y13",13,20,7
"1997_1343",1997,1343,"W12",12,13,1
"1998_1343",1998,1343,"W05",5,12,7
"2001_1343",2001,1343,"Z15",15,20,5
"2004_1343",2004,1343,"W14",14,20,6
"2011_1343",2011,1343,"W13",13,20,7
"2017_1343",2017,1343,"X12",12,20,8
"1987_1344",1987,1344,"X06",6,20,14
"1989_1344",1989,1344,"Z12",12,20,8
"1990_1344",1990,1344,"Z09",9,12,3
"1994_1344",1994,1344,"X08",8,20,12
"1997_1344",1997,1344,"X10",10,20,10
"2001_1344",2001,1344,"Z10",10,20,10
"2004_1344",2004,1344,"Z05",5,20,15
"2014_1344",2014,1344,"W11",11,20,9
"2015_1344",2015,1344,"W06",6,11,5
"2016_1344",2016,1344,"W09",9,6,-3
"2017_1344",2017,1344,"W11a",11,9,-2
"1985_1345",1985,1345,"Z06",6,20,14
"1986_1345",1986,1345,"Y06",6,6,0
"1987_1345",1987,1345,"W03",3,6,3
"1988_1345",1988,1345,"X01",1,3,2
"1990_1345",1990,1345,"X02",2,20,18
"1991_1345",1991,1345,"W07",7,2,-5
"1993_1345",1993,1345,"W09",9,20,11
"1994_1345",1994,1345,"X01",1,9,8
"1995_1345",1995,1345,"Y03",3,1,-2
"1996_1345",1996,1345,"Z01",1,3,2
"1997_1345",1997,1345,"X08",8,1,-7
"1998_1345",1998,1345,"Y02",2,8,6
"1999_1345",1999,1345,"W10",10,2,-8
"2000_1345",2000,1345,"Z06",6,10,4
"2003_1345",2003,1345,"X09",9,20,11
"2007_1345",2007,1345,"Y09",9,20,11
"2008_1345",2008,1345,"Z06",6,9,3
"2009_1345",2009,1345,"Z05",5,6,1
"2010_1345",2010,1345,"X04",4,5,1
"2011_1345",2011,1345,"Z03",3,4,1
"2012_1345",2012,1345,"X10",10,3,-7
"2015_1345",2015,1345,"Y09",9,20,11
"2016_1345",2016,1345,"X05",5,9,4
"2017_1345",2017,1345,"Y04",4,5,1
"1998_1347",1998,1347,"Z16",16,20,4
"2009_1347",2009,1347,"X16",16,20,4
"1988_1348",1988,1348,"W11",11,20,9
"1993_1348",1993,1348,"W08",8,20,12
"1997_1348",1997,1348,"X09",9,20,11
"1998_1348",1998,1348,"Y08",8,9,1
"1999_1348",1999,1348,"X12",12,8,-4
"2017_1348",2017,1348,"Y11",11,20,9
"1986_1350",1986,1350,"W11",11,20,9
"1988_1350",1988,1350,"W13",13,20,7
"1990_1350",1990,1350,"W14",14,20,6
"1991_1350",1991,1350,"W15",15,14,-1
"1998_1350",1998,1350,"W14",14,20,6
"2004_1350",2004,1350,"Y11",11,20,9
"2010_1350",2010,1350,"X07",7,20,13
"2011_1350",2011,1350,"Z12",12,7,-5
"1993_1351",1993,1351,"Y16",16,20,4
"1994_1351",1994,1351,"W15",15,16,1
"1989_1352",1989,1352,"X16",16,20,4
"1990_1352",1990,1352,"W15",15,16,1
"1992_1352",1992,1352,"X16",16,20,4
"2009_1352",2009,1352,"Y15",15,20,5
"2010_1352",2010,1352,"X15",15,15,0
"2015_1352",2015,1352,"X16b",16,20,4
"1989_1353",1989,1353,"W13",13,20,7
"1991_1353",1991,1353,"X09",9,20,11
"1989_1354",1989,1354,"W15",15,20,5
"1996_1354",1996,1354,"Z15",15,20,5
"1998_1354",1998,1354,"Z15",15,20,5
"2000_1354",2000,1354,"X16",16,20,4
"2003_1354",2003,1354,"W16",16,20,4
"2012_1355",2012,1355,"Y14",14,20,6
"2013_1355",2013,1355,"X13",13,14,1
"2016_1355",2016,1355,"Y12",12,20,8
"2017_1355",2017,1355,"X16",16,12,-4
"1993_1356",1993,1356,"X14",14,20,6
"1994_1356",1994,1356,"Z11",11,14,3
"1995_1356",1995,1356,"Y10",10,11,1
"2002_1356",2002,1356,"W11",11,20,9
"2003_1356",2003,1356,"Y11",11,11,0
"2004_1356",2004,1356,"X09",9,11,2
"2005_1356",2005,1356,"X07",7,9,2
"2006_1356",2006,1356,"W11",11,7,-4
"2007_1356",2007,1356,"Z04",4,11,7
"2003_1358",2003,1358,"X15",15,20,5
"2010_1358",2010,1358,"X14",14,20,6
"1999_1359",1999,1359,"Y14",14,20,6
"2000_1359",2000,1359,"Y13",13,14,1
"1987_1360",1987,1360,"Y09",9,20,11
"2003_1360",2003,1360,"X13",13,20,7
"2008_1360",2008,1360,"Z13",13,20,7
"1985_1361",1985,1361,"X13",13,20,7
"2002_1361",2002,1361,"X13",13,20,7
"2006_1361",2006,1361,"X11",11,20,9
"2010_1361",2010,1361,"Y11",11,20,9
"2011_1361",2011,1361,"X02",2,11,9
"2012_1361",2012,1361,"X06",6,2,-4
"2013_1361",2013,1361,"X07",7,6,-1
"2014_1361",2014,1361,"Z04",4,7,3
"2015_1361",2015,1361,"X08",8,4,-4
"1998_1362",1998,1362,"X14",14,20,6
"1996_1363",1996,1363,"X16",16,20,4
"1988_1364",1988,1364,"Y10",10,20,10
"1990_1364",1990,1364,"Y09",9,20,11
"2002_1364",2002,1364,"Z14",14,20,6
"2010_1364",2010,1364,"Y15",15,20,5
"2011_1364",2011,1364,"Y15",15,15,0
"1987_1365",1987,1365,"Z15",15,20,5
"1993_1365",1993,1365,"Z15",15,20,5
"1995_1365",1995,1365,"X12",12,20,8
"1996_1365",1996,1365,"Z10",10,12,2
"2005_1368",2005,1368,"X15",15,20,5
"2000_1369",2000,1369,"Z13",13,20,7
"1988_1371",1988,1371,"Z08",8,20,12
"1989_1371",1989,1371,"X03",3,8,5
"1991_1371",1991,1371,"Z03",3,20,17
"1992_1371",1992,1371,"W04",4,3,-1
"1993_1371",1993,1371,"Y02",2,4,2
"1994_1371",1994,1371,"X10",10,2,-8
"2000_1371",2000,1371,"W10",10,20,10
"2004_1371",2004,1371,"W08",8,20,12
"2006_1371",2006,1371,"Z10",10,20,10
"2016_1371",2016,1371,"X06",6,20,14
"2017_1371",2017,1371,"Z09",9,6,-3
"2009_1372",2009,1372,"X14",14,20,6
"2014_1372",2014,1372,"X12",12,20,8
"2015_1372",2015,1372,"X12",12,12,0
"2016_1372",2016,1372,"W14",14,12,-2
"1989_1373",1989,1373,"W14",14,20,6
"1999_1373",1999,1373,"Z13",13,20,7
"2002_1373",2002,1373,"W16b",16,20,4
"2008_1373",2008,1373,"X13",13,20,7
"2009_1373",2009,1373,"Y09",9,13,4
"2010_1373",2010,1373,"X13",13,9,-4
"1985_1374",1985,1374,"W05",5,20,15
"1988_1374",1988,1374,"W07",7,20,13
"1993_1374",1993,1374,"X10",10,20,10
"2015_1374",2015,1374,"X06",6,20,14
"2017_1374",2017,1374,"W06",6,20,14
"1989_1375",1989,1375,"Z11",11,20,9
"1991_1375",1991,1375,"Z13",13,20,7
"1997_1375",1997,1375,"X13",13,20,7
"1998_1375",1998,1375,"X12",12,13,1
"2006_1375",2006,1375,"Y14",14,20,6
"2008_1375",2008,1375,"W10",10,20,10
"1989_1376",1989,1376,"W12",12,20,8
"1997_1376",1997,1376,"W02",2,20,18
"1998_1376",1998,1376,"W03",3,2,-1
"2004_1376",2004,1376,"Y10",10,20,10
"2017_1376",2017,1376,"W07",7,20,13
"1990_1378",1990,1378,"Z15",15,20,5
"1992_1378",1992,1378,"X11",11,20,9
"2012_1378",2012,1378,"X12b",12,20,8
"1990_1379",1990,1379,"W13",13,20,7
"1991_1379",1991,1379,"W11",11,13,2
"2012_1379",2012,1379,"W09",9,20,11
"1985_1380",1985,1380,"X16",16,20,4
"1987_1380",1987,1380,"Y15",15,20,5
"1988_1380",1988,1380,"Y15",15,15,0
"1989_1380",1989,1380,"Z15",15,15,0
"1993_1380",1993,1380,"Z13",13,20,7
"2006_1380",2006,1380,"W16",16,20,4
"2013_1380",2013,1380,"Z16",16,20,4
"2016_1380",2016,1380,"Z16b",16,20,4
"2001_1381",2001,1381,"W14",14,20,6
"2000_1382",2000,1382,"Y12",12,20,8
"2012_1382",2012,1382,"W14",14,20,6
"1991_1384",1991,1384,"Z15",15,20,5
"1985_1385",1985,1385,"X01",1,20,19
"1986_1385",1986,1385,"Z01",1,1,0
"1987_1385",1987,1385,"Y06",6,1,-5
"1988_1385",1988,1385,"Z11",11,6,-5
"1990_1385",1990,1385,"W06",6,20,14
"1991_1385",1991,1385,"Y04",4,6,2
"1992_1385",1992,1385,"Z07",7,4,-3
"1993_1385",1993,1385,"W05",5,7,2
"1998_1385",1998,1385,"Y07",7,20,13
"1999_1385",1999,1385,"Y03",3,7,4
"2000_1385",2000,1385,"Z02",2,3,1
"2002_1385",2002,1385,"W09",9,20,11
"2011_1385",2011,1385,"Y06",6,20,14
"2015_1385",2015,1385,"X09",9,20,11
"1986_1386",1986,1386,"W06",6,20,14
"1997_1386",1997,1386,"Z04",4,20,16
"2001_1386",2001,1386,"X09",9,20,11
"2003_1386",2003,1386,"W07",7,20,13
"2004_1386",2004,1386,"Y01",1,7,6
"2008_1386",2008,1386,"W11",11,20,9
"2014_1386",2014,1386,"W10",10,20,10
"2016_1386",2016,1386,"Z08",8,20,12
"1994_1387",1994,1387,"Y07",7,20,13
"1995_1387",1995,1387,"W09",9,7,-2
"1998_1387",1998,1387,"Z10",10,20,10
"2000_1387",2000,1387,"Y09",9,20,11
"2012_1387",2012,1387,"Z09",9,20,11
"2013_1387",2013,1387,"Y04",4,9,5
"2014_1387",2014,1387,"Y05",5,4,-1
"1989_1388",1989,1388,"X08",8,20,12
"1997_1388",1997,1388,"Z14",14,20,6
"2005_1388",2005,1388,"X10",10,20,10
"2008_1388",2008,1388,"Y10",10,20,10
"2010_1388",2010,1388,"X10",10,20,10
"2012_1388",2012,1388,"X07",7,20,13
"2013_1388",2013,1388,"Y11b",11,7,-4
"2017_1388",2017,1388,"X07",7,20,13
"1991_1389",1991,1389,"Y12",12,20,8
"1995_1389",1995,1389,"W15",15,20,5
"2011_1389",2011,1389,"Z14",14,20,6
"1989_1390",1989,1390,"W03",3,20,17
"1992_1390",1992,1390,"Z12",12,20,8
"1995_1390",1995,1390,"W10",10,20,10
"1996_1390",1996,1390,"W09",9,10,1
"1997_1390",1997,1390,"Z06",6,9,3
"1998_1390",1998,1390,"Y03",3,6,3
"1999_1390",1999,1390,"Z02",2,3,1
"2000_1390",2000,1390,"X01",1,2,1
"2001_1390",2001,1390,"X01",1,1,0
"2002_1390",2002,1390,"X08",8,1,-7
"2003_1390",2003,1390,"X04",4,8,4
"2004_1390",2004,1390,"X01",1,4,3
"2005_1390",2005,1390,"Y08",8,1,-7
"2007_1390",2007,1390,"X11",11,20,9
"2008_1390",2008,1390,"Y03",3,11,8
"2014_1390",2014,1390,"X10",10,20,10
"2016_1392",2016,1392,"W13",13,20,7
"1985_1393",1985,1393,"W07",7,20,13
"1986_1393",1986,1393,"W02",2,7,5
"1987_1393",1987,1393,"W02",2,2,0
"1988_1393",1988,1393,"W03",3,2,-1
"1989_1393",1989,1393,"Y02",2,3,1
"1990_1393",1990,1393,"Y02",2,2,0
"1991_1393",1991,1393,"W02",2,2,0
"1992_1393",1992,1393,"W06",6,2,-4
"1994_1393",1994,1393,"Z04",4,20,16
"1995_1393",1995,1393,"Y07",7,4,-3
"1996_1393",1996,1393,"Z04",4,7,3
"1998_1393",1998,1393,"Z05",5,20,15
"1999_1393",1999,1393,"Y08",8,5,-3
"2000_1393",2000,1393,"Y04",4,8,4
"2001_1393",2001,1393,"Y05",5,4,-1
"2003_1393",2003,1393,"W03",3,20,17
"2004_1393",2004,1393,"X05",5,3,-2
"2005_1393",2005,1393,"Y04",4,5,1
"2006_1393",2006,1393,"W05",5,4,-1
"2009_1393",2009,1393,"X03",3,20,17
"2010_1393",2010,1393,"Z01",1,3,2
"2011_1393",2011,1393,"W03",3,1,-2
"2012_1393",2012,1393,"W01",1,3,2
"2013_1393",2013,1393,"W04",4,1,-3
"2014_1393",2014,1393,"X03",3,4,1
"2016_1393",2016,1393,"X10",10,20,10
"2007_1394",2007,1394,"Y15",15,20,5
"1987_1395",1987,1395,"W04",4,20,16
"1998_1395",1998,1395,"Y05",5,20,15
"1985_1396",1985,1396,"W08",8,20,12
"1986_1396",1986,1396,"X09",9,8,-1
"1987_1396",1987,1396,"Y02",2,9,7
"1988_1396",1988,1396,"W01",1,2,1
"1990_1396",1990,1396,"W11",11,20,9
"1991_1396",1991,1396,"W10",10,11,1
"1992_1396",1992,1396,"Z11",11,10,-1
"1993_1396",1993,1396,"Z07",7,11,4
"1994_1396",1994,1396,"W04",4,7,3
"1995_1396",1995,1396,"X10",10,4,-6
"1996_1396",1996,1396,"Y07",7,10,3
"1997_1396",1997,1396,"Y09",9,7,-2
"1998_1396",1998,1396,"X07",7,9,2
"1999_1396",1999,1396,"W06",6,7,1
"2000_1396",2000,1396,"W02",2,6,4
"2001_1396",2001,1396,"Z11",11,2,-9
"2008_1396",2008,1396,"Y12",12,20,8
"2009_1396",2009,1396,"X11",11,12,1
"2010_1396",2010,1396,"W05",5,11,6
"2011_1396",2011,1396,"X07",7,5,-2
"2012_1396",2012,1396,"X05",5,7,2
"2013_1396",2013,1396,"W09",9,5,-4
"2016_1396",2016,1396,"Y10",10,20,10
"1989_1397",1989,1397,"W10",10,20,10
"1998_1397",1998,1397,"X08",8,20,12
"1999_1397",1999,1397,"W04",4,8,4
"2000_1397",2000,1397,"X04",4,4,0
"2001_1397",2001,1397,"Y08",8,4,-4
"2006_1397",2006,1397,"Z02",2,20,18
"2007_1397",2007,1397,"X05",5,2,-3
"2008_1397",2008,1397,"W02",2,5,3
"2009_1397",2009,1397,"W09",9,2,-7
"2010_1397",2010,1397,"Y06",6,9,3
"2011_1397",2011,1397,"X09",9,6,-3
"2014_1397",2014,1397,"Y11b",11,20,9
"1993_1398",1993,1398,"Y15",15,20,5
"1994_1398",1994,1398,"X14",14,15,1
"1989_1400",1989,1400,"Y11",11,20,9
"1990_1400",1990,1400,"X10",10,11,1
"1991_1400",1991,1400,"Y05",5,10,5
"1992_1400",1992,1400,"W08",8,5,-3
"1994_1400",1994,1400,"Y06",6,20,14
"1995_1400",1995,1400,"X11",11,6,-5
"1996_1400",1996,1400,"X10",10,11,1
"1997_1400",1997,1400,"W10",10,10,0
"1999_1400",1999,1400,"W07",7,20,13
"2000_1400",2000,1400,"Z05",5,7,2
"2001_1400",2001,1400,"Z06",6,5,-1
"2002_1400",2002,1400,"X06",6,6,0
"2003_1400",2003,1400,"X01",1,6,5
"2004_1400",2004,1400,"W03",3,1,-2
"2005_1400",2005,1400,"X08",8,3,-5
"2006_1400",2006,1400,"W02",2,8,6
"2007_1400",2007,1400,"W04",4,2,-2
"2008_1400",2008,1400,"Y02",2,4,2
"2009_1400",2009,1400,"W07",7,2,-5
"2010_1400",2010,1400,"W08",8,7,-1
"2011_1400",2011,1400,"X04",4,8,4
"2012_1400",2012,1400,"W11",11,4,-7
"2014_1400",2014,1400,"Y07",7,20,13
"2015_1400",2015,1400,"Y11",11,7,-4
"2016_1400",2016,1400,"Z06",6,11,5
"1987_1401",1987,1401,"Y12",12,20,8
"2006_1401",2006,1401,"W12",12,20,8
"2007_1401",2007,1401,"X03",3,12,9
"2008_1401",2008,1401,"Z09",9,3,-6
"2009_1401",2009,1401,"Z09",9,9,0
"2010_1401",2010,1401,"X05",5,9,4
"2011_1401",2011,1401,"Z07",7,5,-2
"2016_1401",2016,1401,"Z03",3,20,17
"1994_1402",1994,1402,"Y15",15,20,5
"1997_1402",1997,1402,"Y16",16,20,4
"1985_1403",1985,1403,"Y06",6,20,14
"1986_1403",1986,1403,"X13",13,6,-7
"1993_1403",1993,1403,"W12",12,20,8
"1996_1403",1996,1403,"W03",3,20,17
"2002_1403",2002,1403,"W06",6,20,14
"2004_1403",2004,1403,"Y08",8,20,12
"2005_1403",2005,1403,"W06",6,8,2
"2007_1403",2007,1403,"W10",10,20,10
"2016_1403",2016,1403,"X08",8,20,12
"1990_1406",1990,1406,"X16",16,20,4
"1991_1406",1991,1406,"Y16",16,16,0
"2003_1407",2003,1407,"X14",14,20,6
"2017_1407",2017,1407,"W15",15,20,5
"1992_1408",1992,1408,"Z10",10,20,10
"1993_1408",1993,1408,"Y11",11,10,-1
"1995_1408",1995,1408,"Z09",9,20,11
"1985_1409",1985,1409,"X06",6,20,14
"1986_1409",1986,1409,"W10",10,6,-4
"1987_1409",1987,1409,"Z11",11,10,-1
"1994_1409",1994,1409,"Y12",12,20,8
"1995_1409",1995,1409,"W06",6,12,6
"1996_1409",1996,1409,"X11",11,6,-5
"1997_1409",1997,1409,"Y05",5,11,6
"1999_1409",1999,1409,"W09",9,20,11
"2000_1409",2000,1409,"X07",7,9,2
"2002_1409",2002,1409,"W12",12,20,8
"2003_1409",2003,1409,"Y13",13,12,-1
"2014_1409",2014,1409,"X13",13,20,7
"2016_1409",2016,1409,"W11b",11,20,9
"1990_1411",1990,1411,"X14",14,20,6
"1994_1411",1994,1411,"X15",15,20,5
"1995_1411",1995,1411,"Y15",15,15,0
"2003_1411",2003,1411,"X16a",16,20,4
"2014_1411",2014,1411,"Y16b",16,20,4
"2015_1411",2015,1411,"Z15",15,16,1
"2017_1411",2017,1411,"Z16",16,20,4
"1985_1412",1985,1412,"Y07",7,20,13
"1986_1412",1986,1412,"Z06",6,7,1
"1987_1412",1987,1412,"X11",11,6,-5
"1990_1412",1990,1412,"W10",10,20,10
"1994_1412",1994,1412,"W07",7,20,13
"1999_1412",1999,1412,"Z12",12,20,8
"2004_1412",2004,1412,"Z09",9,20,11
"2005_1412",2005,1412,"X11",11,9,-2
"2006_1412",2006,1412,"Z09",9,11,2
"2011_1412",2011,1412,"W12b",12,20,8
"2015_1412",2015,1412,"X14",14,20,6
"2017_1413",2017,1413,"Y16b",16,20,4
"2015_1414",2015,1414,"W13",13,20,7
"1994_1416",1994,1416,"X16",16,20,4
"1996_1416",1996,1416,"W16",16,20,4
"2004_1416",2004,1416,"Y14",14,20,6
"2005_1416",2005,1416,"Z15",15,14,-1
"1987_1417",1987,1417,"Z04",4,20,16
"1989_1417",1989,1417,"Z07",7,20,13
"1990_1417",1990,1417,"W07",7,7,0
"1991_1417",1991,1417,"W04",4,7,3
"1992_1417",1992,1417,"X01",1,4,3
"1993_1417",1993,1417,"Z09",9,1,-8
"1994_1417",1994,1417,"Y05",5,9,4
"1995_1417",1995,1417,"X01",1,5,4
"1996_1417",1996,1417,"Y04",4,1,-3
"1997_1417",1997,1417,"Y02",2,4,2
"1998_1417",1998,1417,"Z06",6,2,-4
"1999_1417",1999,1417,"Y05",5,6,1
"2000_1417",2000,1417,"Y06",6,5,-1
"2001_1417",2001,1417,"W04",4,6,2
"2002_1417",2002,1417,"Z08",8,4,-4
"2005_1417",2005,1417,"W11",11,20,9
"2006_1417",2006,1417,"X02",2,11,9
"2007_1417",2007,1417,"Z02",2,2,0
"2008_1417",2008,1417,"Z01",1,2,1
"2009_1417",2009,1417,"W06",6,1,-5
"2011_1417",2011,1417,"Y07",7,20,13
"2013_1417",2013,1417,"X06",6,20,14
"2014_1417",2014,1417,"X04",4,6,2
"2015_1417",2015,1417,"X11",11,4,-7
"2017_1417",2017,1417,"Z03",3,20,17
"1992_1418",1992,1418,"X13",13,20,7
"1994_1418",1994,1418,"X11",11,20,9
"2000_1418",2000,1418,"X13",13,20,7
"2004_1418",2004,1418,"X14",14,20,6
"2005_1418",2005,1418,"W13",13,14,1
"2014_1418",2014,1418,"Z14",14,20,6
"1986_1419",1986,1419,"Z13",13,20,7
"1990_1419",1990,1419,"X15",15,20,5
"1991_1419",1991,1419,"Y15",15,15,0
"1992_1419",1992,1419,"Y15",15,15,0
"1993_1419",1993,1419,"Y13",13,15,2
"1996_1419",1996,1419,"X15",15,20,5
"2008_1420",2008,1420,"X15",15,20,5
"2003_1421",2003,1421,"X16b",16,20,4
"2011_1421",2011,1421,"Y16b",16,20,4
"2012_1421",2012,1421,"W16",16,16,0
"2016_1421",2016,1421,"Y15",15,20,5
"1996_1422",1996,1422,"Y15",15,20,5
"2001_1422",2001,1422,"X16",16,20,4
"2000_1423",2000,1423,"X15",15,20,5
"2002_1423",2002,1423,"Y13",13,20,7
"2003_1423",2003,1423,"X11",11,13,2
"2006_1423",2006,1423,"W09",9,20,11
"2016_1423",2016,1423,"Z13",13,20,7
"2017_1423",2017,1423,"W12",12,13,1
"1985_1424",1985,1424,"X04",4,20,16
"1986_1424",1986,1424,"Z04",4,4,0
"1987_1424",1987,1424,"Z01",1,4,3
"1988_1424",1988,1424,"Z04",4,1,-3
"1989_1424",1989,1424,"X04",4,4,0
"1990_1424",1990,1424,"Z01",1,4,3
"1991_1424",1991,1424,"Z01",1,1,0
"1998_1424",1998,1424,"W12",12,20,8
"2000_1424",2000,1424,"X10",10,20,10
"2007_1424",2007,1424,"Y07",7,20,13
"2008_1424",2008,1424,"X08",8,7,-1
"2010_1424",2010,1424,"Y08",8,20,12
"2011_1424",2011,1424,"Z08",8,8,0
"2012_1424",2012,1424,"Y06",6,8,2
"2013_1424",2013,1424,"W05",5,6,1
"1985_1425",1985,1425,"Y08",8,20,12
"1991_1425",1991,1425,"X10",10,20,10
"1992_1425",1992,1425,"Y02",2,10,8
"1997_1425",1997,1425,"X11",11,20,9
"2001_1425",2001,1425,"W06",6,20,14
"2002_1425",2002,1425,"Y04",4,6,2
"2007_1425",2007,1425,"W05",5,20,15
"2008_1425",2008,1425,"X06",6,5,-1
"2009_1425",2009,1425,"Y10",10,6,-4
"2011_1425",2011,1425,"Z11a",11,20,9
"2016_1425",2016,1425,"W08",8,20,12
"2017_1425",2017,1425,"W11b",11,8,-3
"2008_1426",2008,1426,"Y16",16,20,4
"1988_1427",1988,1427,"Y14",14,20,6
"1999_1427",1999,1427,"Z16",16,20,4
"2004_1427",2004,1427,"X16",16,20,4
"2011_1427",2011,1427,"W16b",16,20,4
"1986_1428",1986,1428,"Z14",14,20,6
"1991_1428",1991,1428,"Z04",4,20,16
"1993_1428",1993,1428,"Y08",8,20,12
"1995_1428",1995,1428,"X04",4,20,16
"1996_1428",1996,1428,"X04",4,4,0
"1997_1428",1997,1428,"Z02",2,4,2
"1998_1428",1998,1428,"X03",3,2,-1
"1999_1428",1999,1428,"X02",2,3,1
"2000_1428",2000,1428,"Y08",8,2,-6
"2002_1428",2002,1428,"Y12",12,20,8
"2003_1428",2003,1428,"Y09",9,12,3
"2004_1428",2004,1428,"Z11",11,9,-2
"2005_1428",2005,1428,"Y06",6,11,5
"2009_1428",2009,1428,"Y05",5,20,15
"2015_1428",2015,1428,"X05",5,20,15
"2016_1428",2016,1428,"X03",3,5,2
"1988_1429",1988,1429,"X10",10,20,10
"1998_1429",1998,1429,"X13",13,20,7
"2000_1429",2000,1429,"X12",12,20,8
"2001_1429",2001,1429,"W12",12,12,0
"2003_1429",2003,1429,"Z15",15,20,5
"2005_1429",2005,1429,"X14",14,20,6
"2006_1429",2006,1429,"Z12",12,14,2
"2009_1429",2009,1429,"Z11",11,20,9
"2010_1429",2010,1429,"X12",12,11,-1
"2011_1429",2011,1429,"Y12",12,12,0
"1985_1431",1985,1431,"X11",11,20,9
"1986_1431",1986,1431,"Z10",10,11,1
"1987_1431",1987,1431,"Z07",7,10,3
"1988_1431",1988,1431,"Z09",9,7,-2
"1989_1431",1989,1431,"X07",7,9,2
"1990_1431",1990,1431,"Y11",11,7,-4
"1992_1431",1992,1431,"Y09",9,20,11
"2004_1431",2004,1431,"X13",13,20,7
"2005_1431",2005,1431,"Y11",11,13,2
"2010_1431",2010,1431,"Z12",12,20,8
"1985_1433",1985,1433,"X02",2,20,18
"1996_1433",1996,1433,"Y12",12,20,8
"2004_1433",2004,1433,"Y13",13,20,7
"2007_1433",2007,1433,"Z11",11,20,9
"2009_1433",2009,1433,"W11",11,20,9
"2011_1433",2011,1433,"Z11b",11,20,9
"2012_1433",2012,1433,"Y12",12,11,-1
"2013_1433",2013,1433,"X05",5,12,7
"2014_1433",2014,1433,"X05",5,5,0
"2015_1433",2015,1433,"Z07",7,5,-2
"2016_1433",2016,1433,"Z10",10,7,-3
"2017_1433",2017,1433,"X10",10,10,0
"1996_1434",1996,1434,"Z14",14,20,6
"1997_1434",1997,1434,"Z12",12,14,2
"1998_1434",1998,1434,"Y13",13,12,-1
"1999_1434",1999,1434,"Y15",15,13,-2
"2000_1434",2000,1434,"Y16",16,15,-1
"2002_1434",2002,1434,"W13",13,20,7
"2004_1434",2004,1434,"Z15",15,20,5
"2013_1434",2013,1434,"Y14",14,20,6
"2015_1434",2015,1434,"Y13",13,20,7
"1988_1435",1988,1435,"X07",7,20,13
"1989_1435",1989,1435,"W08",8,7,-1
"1991_1435",1991,1435,"Z09",9,20,11
"1993_1435",1993,1435,"Z03",3,20,17
"1997_1435",1997,1435,"Y10",10,20,10
"2004_1435",2004,1435,"X06",6,20,14
"2007_1435",2007,1435,"W06",6,20,14
"2008_1435",2008,1435,"X04",4,6,2
"2010_1435",2010,1435,"Z04",4,20,16
"2011_1435",2011,1435,"Z05",5,4,-1
"2012_1435",2012,1435,"W05",5,5,0
"2016_1435",2016,1435,"Y11a",11,20,9
"2017_1435",2017,1435,"X09",9,11,2
"2003_1436",2003,1436,"Z16",16,20,4
"2004_1436",2004,1436,"X15",15,16,1
"2005_1436",2005,1436,"Y13",13,15,2
"2010_1436",2010,1436,"Z16",16,20,4
"2012_1436",2012,1436,"X16b",16,20,4
"2017_1436",2017,1436,"Y13",13,20,7
"1985_1437",1985,1437,"Z08",8,20,12
"1986_1437",1986,1437,"Y10",10,8,-2
"1988_1437",1988,1437,"Y06",6,20,14
"1990_1437",1990,1437,"Y12",12,20,8
"1991_1437",1991,1437,"W09",9,12,3
"1995_1437",1995,1437,"W03",3,20,17
"1996_1437",1996,1437,"X03",3,3,0
"1997_1437",1997,1437,"W04",4,3,-1
"1999_1437",1999,1437,"X08",8,20,12
"2005_1437",2005,1437,"Z05",5,20,15
"2006_1437",2006,1437,"Y01",1,5,4
"2007_1437",2007,1437,"Z09",9,1,-8
"2008_1437",2008,1437,"X12",12,9,-3
"2009_1437",2009,1437,"W03",3,12,9
"2010_1437",2010,1437,"X02",2,3,1
"2011_1437",2011,1437,"W09",9,2,-7
"2013_1437",2013,1437,"X09",9,20,11
"2014_1437",2014,1437,"W02",2,9,7
"2015_1437",2015,1437,"W01",1,2,1
"2016_1437",2016,1437,"Y02",2,1,-1
"2017_1437",2017,1437,"W01",1,2,1
"1986_1438",1986,1438,"W05",5,20,15
"1987_1438",1987,1438,"Z05",5,5,0
"1989_1438",1989,1438,"Z05",5,20,15
"1990_1438",1990,1438,"Y07",7,5,-2
"1991_1438",1991,1438,"Z07",7,7,0
"1993_1438",1993,1438,"W06",6,20,14
"1994_1438",1994,1438,"Z07",7,6,-1
"1995_1438",1995,1438,"Y04",4,7,3
"1997_1438",1997,1438,"Z09",9,20,11
"2001_1438",2001,1438,"Z05",5,20,15
"2007_1438",2007,1438,"X04",4,20,16
"2012_1438",2012,1438,"Z10",10,20,10
"2014_1438",2014,1438,"W01",1,20,19
"2015_1438",2015,1438,"W02",2,1,-1
"2016_1438",2016,1438,"X01",1,2,1
"2017_1438",2017,1438,"W05",5,1,-4
"1985_1439",1985,1439,"W09",9,20,11
"1986_1439",1986,1439,"Y07",7,9,2
"1996_1439",1996,1439,"X09",9,20,11
"2007_1439",2007,1439,"Z05",5,20,15
"2017_1439",2017,1439,"W09",9,20,11
"1996_1441",1996,1441,"Z16",16,20,4
"1986_1443",1986,1443,"Y08",8,20,12
"1987_1443",1987,1443,"W10",10,8,-2
"1993_1443",1993,1443,"Y07",7,20,13
"1994_1443",1994,1443,"Y11",11,7,-4
"1995_1443",1995,1443,"Y08",8,11,3
"2001_1443",2001,1443,"Z14",14,20,6
"2002_1443",2002,1443,"X09",9,14,5
"2003_1443",2003,1443,"Z13",13,9,-4
"2008_1443",2008,1443,"Z12",12,20,8
"2009_1443",2009,1443,"X12",12,12,0
"2012_1443",2012,1443,"Y16b",16,20,4
"2013_1443",2013,1443,"X16",16,16,0
"1998_1444",1998,1444,"Y11",11,20,9
"2004_1444",2004,1444,"X11",11,20,9
"2014_1444",2014,1444,"X14",14,20,6
"2003_1447",2003,1447,"Y15",15,20,5
"1991_1448",1991,1448,"X05",5,20,15
"1992_1448",1992,1448,"X09",9,5,-4
"1993_1448",1993,1448,"Y05",5,9,4
"1994_1448",1994,1448,"X05",5,5,0
"1995_1448",1995,1448,"W01",1,5,4
"1996_1448",1996,1448,"X02",2,1,-1
"1997_1448",1997,1448,"Z03",3,2,-1
"2001_1448",2001,1448,"Y07",7,20,13
"2002_1448",2002,1448,"X07",7,7,0
"2003_1448",2003,1448,"W02",2,7,5
"2004_1448",2004,1448,"Y04",4,2,-2
"2005_1448",2005,1448,"W02",2,4,2
"2009_1448",2009,1448,"Y04",4,20,16
"2010_1448",2010,1448,"W09",9,4,-5
"2017_1448",2017,1448,"Z11b",11,20,9
"1985_1449",1985,1449,"X05",5,20,15
"1986_1449",1986,1449,"X12",12,5,-7
"1998_1449",1998,1449,"W11",11,20,9
"1999_1449",1999,1449,"X07",7,11,4
"2004_1449",2004,1449,"Z08",8,20,12
"2005_1449",2005,1449,"W01",1,8,7
"2006_1449",2006,1449,"Z05",5,1,-4
"2009_1449",2009,1449,"Z04",4,20,16
"2010_1449",2010,1449,"W11",11,4,-7
"2011_1449",2011,1449,"W07",7,11,4
"1994_1450",1994,1450,"W08",8,20,12
"2007_1450",2007,1450,"W03",3,20,17
"2008_1450",2008,1450,"W04",4,3,-1
"1995_1451",1995,1451,"Z14",14,20,6
"1999_1451",1999,1451,"Z14",14,20,6
"2003_1451",2003,1451,"Y12",12,20,8
"2007_1451",2007,1451,"Z15",15,20,5
"2014_1451",2014,1451,"Z16",16,20,4
"2016_1451",2016,1451,"W15",15,20,5
"1986_1452",1986,1452,"W09",9,20,11
"1987_1452",1987,1452,"W07",7,9,2
"1989_1452",1989,1452,"W07",7,20,13
"1992_1452",1992,1452,"W12",12,20,8
"1998_1452",1998,1452,"X10",10,20,10
"2005_1452",2005,1452,"W07",7,20,13
"2006_1452",2006,1452,"W06",6,7,1
"2008_1452",2008,1452,"Z07",7,20,13
"2009_1452",2009,1452,"Y06",6,7,1
"2010_1452",2010,1452,"W02",2,6,4
"2011_1452",2011,1452,"W05",5,2,-3
"2012_1452",2012,1452,"W10",10,5,-5
"2015_1452",2015,1452,"Y05",5,20,15
"2016_1452",2016,1452,"W03",3,5,2
"2017_1452",2017,1452,"X04",4,3,-1
"1991_1453",1991,1453,"Z12",12,20,8
"1994_1453",1994,1453,"Z12",12,20,8
"1995_1453",1995,1453,"Y14",14,12,-2
"1996_1453",1996,1453,"X08",8,14,6
"2016_1453",2016,1453,"Z14",14,20,6
"2003_1454",2003,1454,"Z12",12,20,8
"2005_1454",2005,1454,"X12",12,20,8
"2006_1454",2006,1454,"Y11",11,12,1
"2014_1454",2014,1454,"W15",15,20,5
"1985_1455",1985,1455,"W11",11,20,9
"1987_1455",1987,1455,"Y11",11,20,9
"1988_1455",1988,1455,"X12",12,11,-1
"2006_1455",2006,1455,"Z07",7,20,13
"2012_1455",2012,1455,"Y05",5,20,15
"2013_1455",2013,1455,"Z09",9,5,-4
"2014_1455",2014,1455,"Y01",1,9,8
"2015_1455",2015,1455,"Y07",7,1,-6
"2016_1455",2016,1455,"Y11b",11,7,-4
"2017_1455",2017,1455,"Z10",10,11,1
"1999_1457",1999,1457,"Y16",16,20,4
"2000_1457",2000,1457,"Z14",14,16,2
"2001_1457",2001,1457,"Y16b",16,14,-2
"2002_1457",2002,1457,"Y16",16,16,0
"2005_1457",2005,1457,"W14",14,20,6
"2006_1457",2006,1457,"Z15",15,14,-1
"2007_1457",2007,1457,"Y11",11,15,4
"2008_1457",2008,1457,"W13",13,11,-2
"2010_1457",2010,1457,"X16b",16,20,4
"2017_1457",2017,1457,"Z13",13,20,7
"1994_1458",1994,1458,"Z09",9,20,11
"1997_1458",1997,1458,"W07",7,20,13
"1999_1458",1999,1458,"W05",5,20,15
"2000_1458",2000,1458,"Z08",8,5,-3
"2001_1458",2001,1458,"X06",6,8,2
"2002_1458",2002,1458,"W08",8,6,-2
"2003_1458",2003,1458,"Y05",5,8,3
"2004_1458",2004,1458,"Y06",6,5,-1
"2005_1458",2005,1458,"Z06",6,6,0
"2006_1458",2006,1458,"Y09",9,6,-3
"2007_1458",2007,1458,"Y02",2,9,7
"2008_1458",2008,1458,"X03",3,2,-1
"2009_1458",2009,1458,"W12",12,3,-9
"2010_1458",2010,1458,"W04",4,12,8
"2011_1458",2011,1458,"Y04",4,4,0
"2012_1458",2012,1458,"W04",4,4,0
"2013_1458",2013,1458,"Z05",5,4,-1
"2014_1458",2014,1458,"Z02",2,5,3
"2015_1458",2015,1458,"Z01",1,2,1
"2016_1458",2016,1458,"W07",7,1,-6
"2017_1458",2017,1458,"W08",8,7,-1
"2010_1459",2010,1459,"W13",13,20,7
"2011_1459",2011,1459,"Y14",14,13,-1
"2014_1459",2014,1459,"Y15",15,20,5
"2015_1459",2015,1459,"Z12",12,15,3
"1993_1460",1993,1460,"X16",16,20,4
"2007_1460",2007,1460,"Z14",14,20,6
"1987_1461",1987,1461,"Z12",12,20,8
"1988_1461",1988,1461,"Z07",7,12,5
"2002_1461",2002,1461,"Z11",11,20,9
"2015_1461",2015,1461,"W12",12,20,8
"1986_1462",1986,1462,"Y12",12,20,8
"1987_1462",1987,1462,"Y13",13,12,-1
"1988_1462",1988,1462,"X11",11,13,2
"1989_1462",1989,1462,"Z14",14,11,-3
"1990_1462",1990,1462,"X06",6,14,8
"1991_1462",1991,1462,"Y14",14,6,-8
"1993_1462",1993,1462,"X09",9,20,11
"1995_1462",1995,1462,"Z11",11,20,9
"1997_1462",1997,1462,"Y07",7,20,13
"1998_1462",1998,1462,"W06",6,7,1
"2001_1462",2001,1462,"Y11",11,20,9
"2002_1462",2002,1462,"Z07",7,11,4
"2003_1462",2003,1462,"X03",3,7,4
"2004_1462",2004,1462,"W07",7,3,-4
"2006_1462",2006,1462,"X14",14,20,6
"2007_1462",2007,1462,"X09",9,14,5
"2008_1462",2008,1462,"Z03",3,9,6
"2009_1462",2009,1462,"W04",4,3,-1
"2010_1462",2010,1462,"Z06",6,4,-2
"2011_1462",2011,1462,"W06",6,6,0
"2012_1462",2012,1462,"Y10",10,6,-4
"2014_1462",2014,1462,"Y12b",12,20,8
"2015_1462",2015,1462,"Z06",6,12,6
"2016_1462",2016,1462,"W02",2,6,4
"2017_1462",2017,1462,"X11",11,2,-9
"2016_1463",2016,1463,"Z12",12,20,8
