"","id","Season","Daynum","ID_SeasonTeam1","Team1","ID_SeasonTeam2","Team2","Seed_num_Team1","Seed_Pre_Team1","Seed_Diff_Team1","Seed_num_Team2","Seed_Pre_Team2","Seed_Diff_Team2","Seed_Diff","Result"
"1","1986_1112_1120",1986,137,"1986_1112",1112,"1986_1120",1120,9,10,1,8,11,3,-1,"Lose"
"2","1986_1177_1181",1986,144,"1986_1177",1177,"1986_1181",1181,12,10,-2,1,3,2,-11,"Lose"
"3","1986_1104_1228",1986,139,"1986_1104",1104,"1986_1228",1228,5,7,2,4,3,-1,-1,"Win"
"4","1986_1193_1228",1986,137,"1986_1193",1193,"1986_1228",1228,13,20,7,4,3,-1,-9,"Lose"
"5","1986_1156_1231",1986,137,"1986_1156",1156,"1986_1231",1231,14,20,6,3,20,17,-11,"Win"
"6","1986_1181_1242",1986,152,"1986_1181",1181,"1986_1242",1242,1,3,2,1,3,2,0,"Win"
"7","1986_1104_1246",1986,143,"1986_1104",1104,"1986_1246",1246,5,7,2,1,12,11,-4,"Lose"
"8","1986_1172_1246",1986,137,"1986_1172",1172,"1986_1246",1246,16,20,4,1,12,11,-15,"Lose"
"9","1986_1133_1257",1986,138,"1986_1133",1133,"1986_1257",1257,7,20,13,2,20,18,-5,"Lose"
"10","1986_1120_1257",1986,145,"1986_1120",1120,"1986_1257",1257,8,11,3,2,20,18,-6,"Lose"
"11","1986_1180_1257",1986,136,"1986_1180",1180,"1986_1257",1257,15,20,5,2,20,18,-13,"Lose"
"12","1986_1181_1257",1986,154,"1986_1181",1181,"1986_1257",1257,1,3,2,2,20,18,1,"Lose"
"13","1986_1210_1261",1986,143,"1986_1210",1210,"1986_1261",1261,2,2,0,11,4,-7,9,"Lose"
"14","1986_1246_1261",1986,145,"1986_1246",1246,"1986_1261",1261,1,12,11,11,4,-7,10,"Lose"
"15","1986_1257_1261",1986,152,"1986_1257",1257,"1986_1261",1261,2,20,18,11,4,-7,9,"Win"
"16","1986_1210_1265",1986,136,"1986_1210",1210,"1986_1265",1265,2,2,0,15,20,5,13,"Win"
"17","1986_1123_1272",1986,136,"1986_1123",1123,"1986_1272",1272,14,20,6,3,2,-1,-11,"Lose"
"18","1986_1261_1272",1986,138,"1986_1261",1261,"1986_1272",1272,11,4,-7,3,2,-1,-8,"Win"
"19","1986_1235_1275",1986,137,"1986_1235",1235,"1986_1275",1275,7,13,6,10,12,2,3,"Win"
"20","1986_1103_1276",1986,137,"1986_1103",1103,"1986_1276",1276,15,20,5,2,1,-1,-13,"Lose"
"21","1986_1235_1276",1986,139,"1986_1235",1235,"1986_1276",1276,7,13,6,2,1,-1,-5,"Win"
"22","1986_1207_1277",1986,138,"1986_1207",1207,"1986_1277",1277,4,1,-3,5,10,5,1,"Lose"
"23","1986_1242_1277",1986,144,"1986_1242",1242,"1986_1277",1277,1,3,2,5,10,5,4,"Win"
"24","1986_1181_1290",1986,136,"1986_1181",1181,"1986_1290",1290,1,3,2,16,20,4,15,"Win"
"25","1986_1156_1298",1986,144,"1986_1156",1156,"1986_1298",1298,14,20,6,7,13,6,-7,"Lose"
"26","1986_1181_1298",1986,146,"1986_1181",1181,"1986_1298",1298,1,3,2,7,13,6,6,"Win"
"27","1986_1242_1299",1986,136,"1986_1242",1242,"1986_1299",1299,1,3,2,16,16,0,15,"Win"
"28","1986_1234_1301",1986,137,"1986_1234",1234,"1986_1301",1301,11,8,-3,6,3,-3,-5,"Lose"
"29","1986_1114_1301",1986,139,"1986_1114",1114,"1986_1301",1301,14,20,6,6,3,-3,-8,"Lose"
"30","1986_1242_1301",1986,146,"1986_1242",1242,"1986_1301",1301,1,3,2,6,3,-3,5,"Win"
"31","1986_1235_1301",1986,144,"1986_1235",1235,"1986_1301",1301,7,13,6,6,3,-3,-1,"Lose"
"32","1986_1257_1314",1986,143,"1986_1257",1257,"1986_1314",1314,2,20,18,3,2,-1,1,"Win"
"33","1986_1114_1323",1986,137,"1986_1114",1114,"1986_1323",1323,14,20,6,3,7,4,-11,"Win"
"34","1986_1318_1328",1986,136,"1986_1318",1318,"1986_1328",1328,13,14,1,4,1,-3,-9,"Lose"
"35","1986_1177_1328",1986,138,"1986_1177",1177,"1986_1328",1328,12,10,-2,4,1,-3,-8,"Win"
"36","1986_1181_1330",1986,138,"1986_1181",1181,"1986_1330",1330,1,3,2,8,12,4,7,"Win"
"37","1986_1268_1337",1986,137,"1986_1268",1268,"1986_1337",1337,5,5,0,12,14,2,7,"Win"
"38","1986_1261_1345",1986,136,"1986_1261",1261,"1986_1345",1345,11,4,-7,6,6,0,-5,"Win"
"39","1986_1120_1385",1986,139,"1986_1120",1120,"1986_1385",1385,8,11,3,1,1,0,-7,"Win"
"40","1986_1286_1385",1986,137,"1986_1286",1286,"1986_1385",1385,16,20,4,1,1,0,-15,"Lose"
"41","1986_1350_1386",1986,137,"1986_1350",1350,"1986_1386",1386,11,20,9,6,20,14,-5,"Lose"
"42","1986_1156_1386",1986,139,"1986_1156",1156,"1986_1386",1386,14,20,6,6,20,14,-8,"Win"
"43","1986_1298_1393",1986,139,"1986_1298",1298,"1986_1393",1393,7,13,6,2,7,5,-5,"Win"
"44","1986_1135_1393",1986,137,"1986_1135",1135,"1986_1393",1393,15,20,5,2,7,5,-13,"Lose"
"45","1986_1242_1396",1986,138,"1986_1242",1242,"1986_1396",1396,1,3,2,9,8,-1,8,"Win"
"46","1986_1239_1396",1986,136,"1986_1239",1239,"1986_1396",1396,8,20,12,9,8,-1,1,"Lose"
"47","1986_1207_1403",1986,136,"1986_1207",1207,"1986_1403",1403,4,1,-3,13,6,-7,9,"Win"
"48","1986_1298_1409",1986,137,"1986_1298",1298,"1986_1409",1409,7,13,6,10,6,-4,3,"Win"
"49","1986_1281_1412",1986,136,"1986_1281",1281,"1986_1412",1412,11,20,9,6,7,1,-5,"Lose"
"50","1986_1314_1412",1986,138,"1986_1314",1314,"1986_1412",1412,3,2,-1,6,7,1,3,"Win"
"51","1986_1120_1424",1986,143,"1986_1120",1120,"1986_1424",1424,8,11,3,4,4,0,-4,"Win"
"52","1986_1268_1424",1986,139,"1986_1268",1268,"1986_1424",1424,5,5,0,4,4,0,-1,"Lose"
"53","1986_1419_1424",1986,137,"1986_1419",1419,"1986_1424",1424,13,20,7,4,4,0,-9,"Lose"
"54","1986_1314_1428",1986,136,"1986_1314",1314,"1986_1428",1428,3,2,-1,14,20,6,11,"Win"
"55","1986_1133_1431",1986,136,"1986_1133",1133,"1986_1431",1431,7,20,13,10,11,1,3,"Win"
"56","1986_1210_1437",1986,138,"1986_1210",1210,"1986_1437",1437,2,2,0,10,8,-2,8,"Win"
"57","1986_1177_1438",1986,136,"1986_1177",1177,"1986_1438",1438,12,10,-2,5,20,15,-7,"Win"
"58","1986_1437_1439",1986,136,"1986_1437",1437,"1986_1439",1439,10,8,-2,7,9,2,-3,"Win"
"59","1986_1246_1443",1986,139,"1986_1246",1246,"1986_1443",1443,1,12,11,8,20,12,7,"Win"
"60","1986_1304_1443",1986,137,"1986_1304",1304,"1986_1443",1443,9,20,11,8,20,12,-1,"Lose"
"61","1986_1277_1449",1986,136,"1986_1277",1277,"1986_1449",1449,5,10,5,12,5,-7,7,"Win"
"62","1986_1330_1452",1986,136,"1986_1330",1330,"1986_1452",1452,8,12,4,9,20,11,1,"Win"
"63","1986_1104_1462",1986,137,"1986_1104",1104,"1986_1462",1462,5,7,2,12,20,8,7,"Win"
"64","1987_1137_1207",1987,137,"1987_1137",1137,"1987_1207",1207,16,20,4,1,4,3,-15,"Lose"
"65","1987_1122_1228",1987,136,"1987_1122",1122,"1987_1228",1228,14,20,6,3,4,1,-11,"Win"
"66","1987_1120_1231",1987,138,"1987_1120",1120,"1987_1231",1231,8,8,0,1,3,2,-7,"Lose"
"67","1987_1193_1231",1987,136,"1987_1193",1193,"1987_1231",1231,16,13,-3,1,3,2,-15,"Lose"
"68","1987_1181_1231",1987,144,"1987_1181",1181,"1987_1231",1231,5,1,-4,1,3,2,-4,"Lose"
"69","1987_1207_1242",1987,143,"1987_1207",1207,"1987_1242",1242,1,4,3,5,1,-4,4,"Win"
"70","1987_1222_1242",1987,137,"1987_1222",1222,"1987_1242",1242,12,20,8,5,1,-4,-7,"Lose"
"71","1987_1208_1243",1987,136,"1987_1208",1208,"1987_1243",1243,8,20,12,9,20,11,1,"Lose"
"72","1987_1177_1256",1987,137,"1987_1177",1177,"1987_1256",1256,3,12,9,14,20,6,11,"Win"
"73","1987_1210_1261",1987,137,"1987_1210",1210,"1987_1261",1261,7,2,-5,10,11,1,3,"Lose"
"74","1987_1177_1261",1987,144,"1987_1177",1177,"1987_1261",1261,3,12,9,10,11,1,7,"Lose"
"75","1987_1231_1261",1987,146,"1987_1231",1231,"1987_1261",1261,1,3,2,10,11,1,9,"Win"
"76","1987_1155_1283",1987,137,"1987_1155",1155,"1987_1283",1283,4,20,16,13,20,7,9,"Lose"
"77","1987_1242_1283",1987,139,"1987_1242",1242,"1987_1283",1283,5,1,-4,13,20,7,8,"Win"
"78","1987_1276_1298",1987,136,"1987_1276",1276,"1987_1298",1298,9,2,-7,8,7,-1,-1,"Win"
"79","1987_1104_1299",1987,136,"1987_1104",1104,"1987_1299",1299,2,5,3,15,16,1,13,"Win"
"80","1987_1196_1301",1987,137,"1987_1196",1196,"1987_1301",1301,6,20,14,11,6,-5,5,"Win"
"81","1987_1104_1309",1987,138,"1987_1104",1104,"1987_1309",1309,2,5,3,7,20,13,5,"Win"
"82","1987_1140_1309",1987,136,"1987_1140",1140,"1987_1309",1309,10,20,10,7,20,13,-3,"Lose"
"83","1987_1276_1314",1987,138,"1987_1276",1276,"1987_1314",1314,9,2,-7,1,3,2,-8,"Lose"
"84","1987_1292_1323",1987,136,"1987_1292",1292,"1987_1323",1323,12,20,8,5,3,-2,-7,"Lose"
"85","1987_1314_1323",1987,143,"1987_1314",1314,"1987_1323",1323,1,3,2,5,3,-2,4,"Win"
"86","1987_1246_1326",1987,137,"1987_1246",1246,"1987_1326",1326,8,1,-7,9,20,11,1,"Lose"
"87","1987_1207_1326",1987,139,"1987_1207",1207,"1987_1326",1326,1,4,3,9,20,11,8,"Win"
"88","1987_1234_1328",1987,144,"1987_1234",1234,"1987_1328",1328,2,11,9,6,4,-2,4,"Win"
"89","1987_1314_1335",1987,136,"1987_1314",1314,"1987_1335",1335,1,3,2,16,20,4,15,"Win"
"90","1987_1328_1338",1987,139,"1987_1328",1328,"1987_1338",1338,6,4,-2,3,20,17,-3,"Win"
"91","1987_1265_1338",1987,137,"1987_1265",1265,"1987_1338",1338,14,15,1,3,20,17,-11,"Lose"
"92","1987_1104_1344",1987,143,"1987_1104",1104,"1987_1344",1344,2,5,3,6,20,14,4,"Lose"
"93","1987_1207_1344",1987,145,"1987_1207",1207,"1987_1344",1344,1,4,3,6,20,14,5,"Lose"
"94","1987_1122_1344",1987,138,"1987_1122",1122,"1987_1344",1344,14,20,6,6,20,14,-8,"Lose"
"95","1987_1196_1345",1987,139,"1987_1196",1196,"1987_1345",1345,6,20,14,3,6,3,-3,"Win"
"96","1987_1318_1345",1987,137,"1987_1318",1318,"1987_1345",1345,14,13,-1,3,6,3,-11,"Lose"
"97","1987_1120_1360",1987,136,"1987_1120",1120,"1987_1360",1360,8,8,0,9,20,11,1,"Win"
"98","1987_1234_1365",1987,137,"1987_1234",1234,"1987_1365",1365,2,11,9,15,20,5,13,"Win"
"99","1987_1177_1385",1987,139,"1987_1177",1177,"1987_1385",1385,3,12,9,6,1,-5,3,"Win"
"100","1987_1344_1393",1987,152,"1987_1344",1344,"1987_1393",1393,6,20,14,2,2,0,-4,"Lose"
"101","1987_1204_1393",1987,137,"1987_1204",1204,"1987_1393",1393,15,20,5,2,2,0,-13,"Lose"
"102","1987_1196_1393",1987,143,"1987_1196",1196,"1987_1393",1393,6,20,14,2,2,0,-4,"Lose"
"103","1987_1231_1393",1987,154,"1987_1231",1231,"1987_1393",1393,1,3,2,2,2,0,1,"Win"
"104","1987_1314_1393",1987,145,"1987_1314",1314,"1987_1393",1393,1,3,2,2,2,0,1,"Lose"
"105","1987_1267_1395",1987,136,"1987_1267",1267,"1987_1395",1395,13,20,7,4,20,16,-9,"Lose"
"106","1987_1323_1395",1987,138,"1987_1323",1323,"1987_1395",1395,5,3,-2,4,20,16,-1,"Win"
"107","1987_1261_1396",1987,139,"1987_1261",1261,"1987_1396",1396,10,11,1,2,9,7,-8,"Win"
"108","1987_1380_1396",1987,137,"1987_1380",1380,"1987_1396",1396,15,20,5,2,9,7,-13,"Lose"
"109","1987_1181_1401",1987,136,"1987_1181",1181,"1987_1401",1401,5,1,-4,12,20,8,7,"Win"
"110","1987_1328_1409",1987,137,"1987_1328",1328,"1987_1409",1409,6,4,-2,11,10,-1,5,"Win"
"111","1987_1344_1412",1987,136,"1987_1344",1344,"1987_1412",1412,6,20,14,11,6,-5,5,"Win"
"112","1987_1141_1417",1987,136,"1987_1141",1141,"1987_1417",1417,13,20,7,4,20,16,-9,"Lose"
"113","1987_1234_1424",1987,146,"1987_1234",1234,"1987_1424",1424,2,11,9,1,4,3,-1,"Lose"
"114","1987_1231_1424",1987,152,"1987_1231",1231,"1987_1424",1424,1,3,2,1,4,3,0,"Win"
"115","1987_1226_1424",1987,136,"1987_1226",1226,"1987_1424",1424,16,20,4,1,4,3,-15,"Lose"
"116","1987_1243_1424",1987,138,"1987_1243",1243,"1987_1424",1424,9,20,11,1,4,3,-8,"Lose"
"117","1987_1112_1431",1987,137,"1987_1112",1112,"1987_1431",1431,10,9,-1,7,10,3,-3,"Lose"
"118","1987_1234_1431",1987,139,"1987_1234",1234,"1987_1431",1431,2,11,9,7,10,3,5,"Win"
"119","1987_1393_1443",1987,139,"1987_1393",1393,"1987_1443",1443,2,2,0,10,8,-2,8,"Win"
"120","1987_1443_1452",1987,137,"1987_1443",1443,"1987_1452",1452,10,8,-2,7,9,2,-3,"Win"
"121","1987_1385_1455",1987,137,"1987_1385",1385,"1987_1455",1455,6,1,-5,11,20,9,5,"Win"
"122","1987_1417_1461",1987,138,"1987_1417",1417,"1987_1461",1461,4,20,16,12,20,8,8,"Lose"
"123","1987_1424_1461",1987,144,"1987_1424",1424,"1987_1461",1461,1,4,3,12,20,8,11,"Win"
"124","1987_1438_1461",1987,136,"1987_1438",1438,"1987_1461",1461,5,5,0,12,20,8,7,"Lose"
"125","1987_1181_1462",1987,138,"1987_1181",1181,"1987_1462",1462,5,1,-4,13,12,-1,8,"Win"
"126","1987_1281_1462",1987,136,"1987_1281",1281,"1987_1462",1462,4,11,7,13,12,-1,9,"Lose"
"127","1988_1120_1133",1988,136,"1988_1120",1120,"1988_1133",1133,8,8,0,9,20,11,1,"Win"
"128","1988_1140_1150",1988,136,"1988_1140",1140,"1988_1150",1150,4,10,6,13,20,7,9,"Win"
"129","1988_1112_1165",1988,137,"1988_1112",1112,"1988_1165",1165,1,10,9,16,20,4,15,"Win"
"130","1988_1131_1181",1988,136,"1988_1131",1131,"1988_1181",1181,15,20,5,2,5,3,-13,"Lose"
"131","1988_1112_1234",1988,144,"1988_1112",1112,"1988_1234",1234,1,10,9,5,2,-3,4,"Win"
"132","1988_1199_1234",1988,137,"1988_1199",1199,"1988_1234",1234,12,20,8,5,2,-3,-7,"Lose"
"133","1988_1210_1235",1988,137,"1988_1210",1210,"1988_1235",1235,5,7,2,12,20,8,7,"Win"
"134","1988_1181_1242",1988,152,"1988_1181",1181,"1988_1242",1242,2,5,3,6,5,-1,4,"Lose"
"135","1988_1242_1243",1988,146,"1988_1242",1242,"1988_1243",1243,6,5,-1,4,9,5,-2,"Win"
"136","1988_1177_1243",1988,138,"1988_1177",1177,"1988_1243",1243,5,3,-2,4,9,5,-1,"Lose"
"137","1988_1243_1247",1988,136,"1988_1243",1243,"1988_1247",1247,4,9,5,13,20,7,9,"Win"
"138","1988_1140_1257",1988,138,"1988_1140",1140,"1988_1257",1257,4,10,6,5,20,15,1,"Lose"
"139","1988_1207_1261",1988,137,"1988_1207",1207,"1988_1261",1261,8,1,-7,9,10,1,1,"Win"
"140","1988_1246_1268",1988,139,"1988_1246",1246,"1988_1268",1268,2,8,6,7,20,13,5,"Win"
"141","1988_1124_1272",1988,136,"1988_1124",1124,"1988_1272",1272,8,20,12,9,20,11,1,"Lose"
"142","1988_1196_1276",1988,138,"1988_1196",1196,"1988_1276",1276,6,6,0,3,9,6,-3,"Lose"
"143","1988_1129_1276",1988,136,"1988_1129",1129,"1988_1276",1276,14,20,6,3,9,6,-11,"Lose"
"144","1988_1242_1293",1988,139,"1988_1242",1242,"1988_1293",1293,6,5,-1,14,20,6,8,"Win"
"145","1988_1293_1301",1988,137,"1988_1293",1293,"1988_1301",1301,14,20,6,3,11,8,-11,"Win"
"146","1988_1112_1314",1988,146,"1988_1112",1112,"1988_1314",1314,1,10,9,2,1,-1,1,"Win"
"147","1988_1276_1314",1988,144,"1988_1276",1276,"1988_1314",1314,3,9,6,2,1,-1,-1,"Lose"
"148","1988_1258_1314",1988,138,"1988_1258",1258,"1988_1314",1314,10,20,10,2,1,-1,-8,"Lose"
"149","1988_1314_1317",1988,136,"1988_1314",1314,"1988_1317",1317,2,1,-1,15,20,5,13,"Win"
"150","1988_1120_1328",1988,138,"1988_1120",1120,"1988_1328",1328,8,8,0,1,6,5,-7,"Lose"
"151","1988_1257_1328",1988,143,"1988_1257",1257,"1988_1328",1328,5,20,15,1,6,5,-4,"Lose"
"152","1988_1242_1328",1988,154,"1988_1242",1242,"1988_1328",1328,6,5,-1,1,6,5,-5,"Win"
"153","1988_1112_1328",1988,152,"1988_1112",1112,"1988_1328",1328,1,10,9,1,6,5,0,"Lose"
"154","1988_1151_1328",1988,136,"1988_1151",1151,"1988_1328",1328,16,20,4,1,6,5,-15,"Lose"
"155","1988_1257_1333",1988,136,"1988_1257",1257,"1988_1333",1333,5,20,15,12,20,8,7,"Win"
"156","1988_1185_1338",1988,137,"1988_1185",1185,"1988_1338",1338,15,20,5,2,3,1,-13,"Lose"
"157","1988_1192_1345",1988,136,"1988_1192",1192,"1988_1345",1345,16,20,4,1,3,2,-15,"Lose"
"158","1988_1243_1345",1988,144,"1988_1243",1243,"1988_1345",1345,4,9,5,1,3,2,-3,"Win"
"159","1988_1272_1345",1988,138,"1988_1272",1272,"1988_1345",1345,9,20,11,1,3,2,-8,"Lose"
"160","1988_1281_1348",1988,136,"1988_1281",1281,"1988_1348",1348,6,4,-2,11,20,9,5,"Lose"
"161","1988_1181_1348",1988,143,"1988_1181",1181,"1988_1348",1348,2,5,3,11,20,9,9,"Win"
"162","1988_1210_1350",1988,139,"1988_1210",1210,"1988_1350",1350,5,7,2,13,20,7,8,"Lose"
"163","1988_1231_1350",1988,137,"1988_1231",1231,"1988_1350",1350,4,1,-3,13,20,7,9,"Lose"
"164","1988_1268_1364",1988,137,"1988_1268",1268,"1988_1364",1364,7,20,13,10,20,10,3,"Win"
"165","1988_1112_1371",1988,139,"1988_1112",1112,"1988_1371",1371,1,10,9,8,20,12,7,"Win"
"166","1988_1323_1374",1988,136,"1988_1323",1323,"1988_1374",1374,10,5,-5,7,20,13,-3,"Lose"
"167","1988_1181_1374",1988,138,"1988_1181",1181,"1988_1374",1374,2,5,3,7,20,13,5,"Win"
"168","1988_1246_1380",1988,137,"1988_1246",1246,"1988_1380",1380,2,8,6,15,15,0,13,"Win"
"169","1988_1196_1385",1988,136,"1988_1196",1196,"1988_1385",1385,6,6,0,11,6,-5,5,"Win"
"170","1988_1348_1393",1988,138,"1988_1348",1348,"1988_1393",1393,11,20,9,3,2,-1,-8,"Win"
"171","1988_1299_1393",1988,136,"1988_1299",1299,"1988_1393",1393,14,15,1,3,2,-1,-11,"Lose"
"172","1988_1181_1396",1988,145,"1988_1181",1181,"1988_1396",1396,2,5,3,1,2,1,-1,"Win"
"173","1988_1350_1396",1988,143,"1988_1350",1350,"1988_1396",1396,13,20,7,1,2,1,-12,"Lose"
"174","1988_1207_1396",1988,139,"1988_1207",1207,"1988_1396",1396,8,1,-7,1,2,1,-7,"Lose"
"175","1988_1250_1396",1988,137,"1988_1250",1250,"1988_1396",1396,16,20,4,1,2,1,-15,"Lose"
"176","1988_1234_1424",1988,139,"1988_1234",1234,"1988_1424",1424,5,2,-3,4,1,-3,-1,"Win"
"177","1988_1283_1424",1988,137,"1988_1283",1283,"1988_1424",1424,13,13,0,4,1,-3,-9,"Lose"
"178","1988_1228_1427",1988,137,"1988_1228",1228,"1988_1427",1427,3,3,0,14,20,6,11,"Win"
"179","1988_1371_1431",1988,137,"1988_1371",1371,"1988_1431",1431,8,20,12,9,7,-2,1,"Win"
"180","1988_1338_1435",1988,139,"1988_1338",1338,"1988_1435",1435,2,3,1,7,20,13,5,"Lose"
"181","1988_1242_1435",1988,144,"1988_1242",1242,"1988_1435",1435,6,5,-1,7,20,13,1,"Win"
"182","1988_1429_1435",1988,137,"1988_1429",1429,"1988_1435",1435,10,20,10,7,20,13,-3,"Lose"
"183","1988_1116_1437",1988,137,"1988_1116",1116,"1988_1437",1437,11,20,9,6,20,14,-5,"Lose"
"184","1988_1246_1437",1988,143,"1988_1246",1246,"1988_1437",1437,2,8,6,6,20,14,4,"Lose"
"185","1988_1328_1437",1988,145,"1988_1328",1328,"1988_1437",1437,1,6,5,6,20,14,5,"Win"
"186","1988_1228_1437",1988,139,"1988_1228",1228,"1988_1437",1437,3,3,0,6,20,14,3,"Lose"
"187","1988_1177_1455",1988,136,"1988_1177",1177,"1988_1455",1455,5,3,-2,12,11,-1,7,"Win"
"188","1988_1258_1461",1988,136,"1988_1258",1258,"1988_1461",1461,10,20,10,7,12,5,-3,"Win"
"189","1988_1242_1462",1988,137,"1988_1242",1242,"1988_1462",1462,6,5,-1,11,13,2,5,"Win"
"190","1989_1112_1155",1989,138,"1989_1112",1112,"1989_1155",1155,1,1,0,9,20,11,8,"Win"
"191","1989_1161_1196",1989,137,"1989_1161",1161,"1989_1196",1196,10,20,10,7,6,-1,-3,"Win"
"192","1989_1181_1207",1989,146,"1989_1181",1181,"1989_1207",1207,2,2,0,1,8,7,-1,"Win"
"193","1989_1123_1228",1989,138,"1989_1123",1123,"1989_1228",1228,9,20,11,1,3,2,-8,"Lose"
"194","1989_1206_1231",1989,137,"1989_1206",1206,"1989_1231",1231,15,20,5,2,4,2,-13,"Lose"
"195","1989_1247_1256",1989,136,"1989_1247",1247,"1989_1256",1256,8,13,5,9,20,11,1,"Lose"
"196","1989_1116_1257",1989,138,"1989_1116",1116,"1989_1257",1257,5,11,6,4,5,1,-1,"Lose"
"197","1989_1228_1257",1989,144,"1989_1228",1228,"1989_1257",1257,1,3,2,4,5,1,3,"Win"
"198","1989_1114_1257",1989,136,"1989_1114",1114,"1989_1257",1257,13,20,7,4,5,1,-9,"Lose"
"199","1989_1116_1258",1989,136,"1989_1116",1116,"1989_1258",1258,5,11,6,12,10,-2,7,"Win"
"200","1989_1228_1270",1989,136,"1989_1228",1228,"1989_1270",1270,1,3,2,16,20,4,15,"Win"
"201","1989_1177_1272",1989,136,"1989_1177",1177,"1989_1272",1272,12,5,-7,5,9,4,-7,"Win"
"202","1989_1228_1276",1989,152,"1989_1228",1228,"1989_1276",1276,1,3,2,3,3,0,2,"Lose"
"203","1989_1243_1278",1989,136,"1989_1243",1243,"1989_1278",1278,6,4,-2,11,20,9,5,"Lose"
"204","1989_1181_1278",1989,144,"1989_1181",1181,"1989_1278",1278,2,2,0,11,20,9,9,"Win"
"205","1989_1166_1281",1989,137,"1989_1166",1166,"1989_1281",1281,14,20,6,3,6,3,-11,"Lose"
"206","1989_1199_1292",1989,136,"1989_1199",1199,"1989_1292",1292,4,12,8,13,20,7,9,"Lose"
"207","1989_1207_1301",1989,144,"1989_1207",1207,"1989_1301",1301,1,8,7,5,3,-2,4,"Win"
"208","1989_1234_1301",1989,139,"1989_1234",1234,"1989_1301",1301,4,5,1,5,3,-2,1,"Lose"
"209","1989_1276_1314",1989,143,"1989_1276",1276,"1989_1314",1314,3,3,0,2,2,0,-1,"Win"
"210","1989_1207_1323",1989,139,"1989_1207",1207,"1989_1323",1323,1,8,7,9,10,1,8,"Win"
"211","1989_1256_1328",1989,138,"1989_1256",1256,"1989_1328",1328,9,20,11,1,1,0,-8,"Lose"
"212","1989_1190_1328",1989,136,"1989_1190",1190,"1989_1328",1328,16,20,4,1,1,0,-15,"Lose"
"213","1989_1191_1333",1989,137,"1989_1191",1191,"1989_1333",1333,11,20,9,6,12,6,-5,"Win"
"214","1989_1123_1338",1989,136,"1989_1123",1123,"1989_1338",1338,9,20,11,8,2,-6,-1,"Win"
"215","1989_1207_1343",1989,137,"1989_1207",1207,"1989_1343",1343,1,8,7,16,20,4,15,"Win"
"216","1989_1112_1352",1989,136,"1989_1112",1112,"1989_1352",1352,1,1,0,16,20,4,15,"Win"
"217","1989_1234_1353",1989,137,"1989_1234",1234,"1989_1353",1353,4,5,1,13,20,7,9,"Win"
"218","1989_1181_1354",1989,136,"1989_1181",1181,"1989_1354",1354,2,2,0,15,20,5,13,"Win"
"219","1989_1191_1371",1989,139,"1989_1191",1191,"1989_1371",1371,11,20,9,3,8,5,-8,"Lose"
"220","1989_1181_1371",1989,152,"1989_1181",1181,"1989_1371",1371,2,2,0,3,8,5,1,"Lose"
"221","1989_1231_1371",1989,143,"1989_1231",1231,"1989_1371",1371,2,4,2,3,8,5,1,"Lose"
"222","1989_1283_1371",1989,137,"1989_1283",1283,"1989_1371",1371,14,13,-1,3,8,5,-11,"Lose"
"223","1989_1276_1371",1989,154,"1989_1276",1276,"1989_1371",1371,3,3,0,3,8,5,0,"Win"
"224","1989_1278_1373",1989,138,"1989_1278",1278,"1989_1373",1373,11,20,9,14,20,6,3,"Win"
"225","1989_1104_1375",1989,137,"1989_1104",1104,"1989_1375",1375,6,20,14,11,20,9,5,"Lose"
"226","1989_1276_1375",1989,139,"1989_1276",1276,"1989_1375",1375,3,3,0,11,20,9,8,"Win"
"227","1989_1301_1376",1989,137,"1989_1301",1301,"1989_1376",1376,5,3,-2,12,20,8,7,"Win"
"228","1989_1314_1380",1989,137,"1989_1314",1314,"1989_1380",1380,2,2,0,15,15,0,13,"Win"
"229","1989_1155_1388",1989,136,"1989_1155",1155,"1989_1388",1388,9,20,11,8,20,12,-1,"Win"
"230","1989_1373_1390",1989,136,"1989_1373",1373,"1989_1390",1390,14,20,6,3,20,17,-11,"Win"
"231","1989_1281_1393",1989,144,"1989_1281",1281,"1989_1393",1393,3,6,3,2,3,1,-1,"Lose"
"232","1989_1161_1393",1989,139,"1989_1161",1161,"1989_1393",1393,10,20,10,2,3,1,-8,"Lose"
"233","1989_1137_1393",1989,137,"1989_1137",1137,"1989_1393",1393,15,20,5,2,3,1,-13,"Lose"
"234","1989_1228_1393",1989,146,"1989_1228",1228,"1989_1393",1393,1,3,2,2,3,1,1,"Win"
"235","1989_1281_1400",1989,139,"1989_1281",1281,"1989_1400",1400,3,6,3,11,20,9,8,"Win"
"236","1989_1210_1400",1989,137,"1989_1210",1210,"1989_1400",1400,6,5,-1,11,20,9,5,"Lose"
"237","1989_1235_1417",1989,137,"1989_1235",1235,"1989_1417",1417,10,12,2,7,20,13,-3,"Lose"
"238","1989_1314_1417",1989,139,"1989_1314",1314,"1989_1417",1417,2,2,0,7,20,13,5,"Win"
"239","1989_1112_1424",1989,143,"1989_1112",1112,"1989_1424",1424,1,1,0,4,4,0,3,"Lose"
"240","1989_1225_1424",1989,136,"1989_1225",1225,"1989_1424",1424,13,20,7,4,4,0,-9,"Lose"
"241","1989_1371_1424",1989,145,"1989_1371",1371,"1989_1424",1424,3,8,5,4,4,0,1,"Win"
"242","1989_1177_1424",1989,138,"1989_1177",1177,"1989_1424",1424,12,5,-7,4,4,0,-8,"Lose"
"243","1989_1231_1431",1989,139,"1989_1231",1231,"1989_1431",1431,2,4,2,7,9,2,5,"Win"
"244","1989_1261_1431",1989,137,"1989_1261",1261,"1989_1431",1431,10,9,-1,7,9,2,-3,"Lose"
"245","1989_1323_1435",1989,137,"1989_1323",1323,"1989_1435",1435,9,10,1,8,7,-1,-1,"Win"
"246","1989_1276_1438",1989,145,"1989_1276",1276,"1989_1438",1438,3,3,0,5,20,15,2,"Win"
"247","1989_1292_1438",1989,138,"1989_1292",1292,"1989_1438",1438,13,20,7,5,20,15,-8,"Lose"
"248","1989_1328_1438",1989,143,"1989_1328",1328,"1989_1438",1438,1,1,0,5,20,15,4,"Lose"
"249","1989_1344_1438",1989,136,"1989_1344",1344,"1989_1438",1438,12,20,8,5,20,15,-7,"Lose"
"250","1989_1397_1452",1989,136,"1989_1397",1397,"1989_1452",1452,10,20,10,7,20,13,-3,"Lose"
"251","1989_1181_1452",1989,138,"1989_1181",1181,"1989_1452",1452,2,2,0,7,20,13,5,"Win"
"252","1989_1276_1462",1989,137,"1989_1276",1276,"1989_1462",1462,3,3,0,14,11,-3,11,"Win"
"253","1990_1104_1112",1990,139,"1990_1104",1104,"1990_1112",1112,7,6,-1,2,1,-1,-5,"Win"
"254","1990_1140_1155",1990,136,"1990_1140",1140,"1990_1155",1155,12,20,8,5,9,4,-7,"Lose"
"255","1990_1104_1161",1990,137,"1990_1104",1104,"1990_1161",1161,7,6,-1,10,10,0,3,"Win"
"256","1990_1143_1163",1990,138,"1990_1143",1143,"1990_1163",1163,9,20,11,1,20,19,-8,"Lose"
"257","1990_1131_1163",1990,136,"1990_1131",1131,"1990_1163",1163,16,20,4,1,20,19,-15,"Lose"
"258","1990_1155_1163",1990,143,"1990_1155",1155,"1990_1163",1163,5,9,4,1,20,19,-4,"Lose"
"259","1990_1116_1173",1990,138,"1990_1116",1116,"1990_1173",1173,4,5,1,12,20,8,8,"Win"
"260","1990_1116_1181",1990,152,"1990_1116",1116,"1990_1181",1181,4,5,1,3,2,-1,-1,"Lose"
"261","1990_1163_1181",1990,145,"1990_1163",1163,"1990_1181",1181,1,20,19,3,2,-1,2,"Lose"
"262","1990_1190_1210",1990,136,"1990_1190",1190,"1990_1210",1210,13,16,3,4,6,2,-9,"Lose"
"263","1990_1173_1228",1990,136,"1990_1173",1173,"1990_1228",1228,12,20,8,5,1,-4,-7,"Win"
"264","1990_1143_1231",1990,136,"1990_1143",1143,"1990_1231",1231,9,20,11,8,2,-6,-1,"Win"
"265","1990_1155_1247",1990,138,"1990_1155",1155,"1990_1247",1247,5,9,4,4,8,4,-1,"Win"
"266","1990_1225_1257",1990,136,"1990_1225",1225,"1990_1257",1257,13,13,0,4,4,0,-9,"Lose"
"267","1990_1123_1257",1990,138,"1990_1123",1123,"1990_1257",1257,12,9,-3,4,4,0,-8,"Win"
"268","1990_1104_1258",1990,144,"1990_1104",1104,"1990_1258",1258,7,6,-1,11,12,1,4,"Lose"
"269","1990_1210_1261",1990,138,"1990_1210",1210,"1990_1261",1261,4,6,2,5,10,5,1,"Win"
"270","1990_1229_1276",1990,137,"1990_1229",1229,"1990_1276",1276,14,20,6,3,3,0,-11,"Lose"
"271","1990_1258_1276",1990,139,"1990_1258",1258,"1990_1276",1276,11,12,1,3,3,0,-8,"Win"
"272","1990_1210_1277",1990,144,"1990_1210",1210,"1990_1277",1277,4,6,2,1,20,19,-3,"Win"
"273","1990_1210_1278",1990,146,"1990_1210",1210,"1990_1278",1278,4,6,2,6,11,5,2,"Win"
"274","1990_1277_1293",1990,136,"1990_1277",1277,"1990_1293",1293,1,20,19,16,20,4,15,"Win"
"275","1990_1258_1308",1990,137,"1990_1258",1258,"1990_1308",1308,11,12,1,6,20,14,-5,"Win"
"276","1990_1283_1314",1990,136,"1990_1283",1283,"1990_1314",1314,9,14,5,8,2,-6,-1,"Lose"
"277","1990_1116_1314",1990,143,"1990_1116",1116,"1990_1314",1314,4,5,1,8,2,-6,4,"Win"
"278","1990_1278_1320",1990,139,"1990_1278",1278,"1990_1320",1320,6,11,5,14,20,6,8,"Win"
"279","1990_1281_1320",1990,137,"1990_1281",1281,"1990_1320",1320,3,3,0,14,20,6,11,"Lose"
"280","1990_1314_1328",1990,138,"1990_1314",1314,"1990_1328",1328,8,2,-6,1,1,0,-7,"Win"
"281","1990_1123_1333",1990,136,"1990_1123",1123,"1990_1333",1333,12,9,-3,5,6,1,-7,"Win"
"282","1990_1116_1343",1990,136,"1990_1116",1116,"1990_1343",1343,4,5,1,13,16,3,9,"Win"
"283","1990_1326_1344",1990,136,"1990_1326",1326,"1990_1344",1344,8,20,12,9,12,3,1,"Win"
"284","1990_1181_1350",1990,137,"1990_1181",1181,"1990_1350",1350,3,2,-1,14,20,6,11,"Win"
"285","1990_1242_1352",1990,137,"1990_1242",1242,"1990_1352",1352,2,20,18,15,16,1,13,"Win"
"286","1990_1277_1364",1990,138,"1990_1277",1277,"1990_1364",1364,1,20,19,9,20,11,8,"Win"
"287","1990_1222_1364",1990,136,"1990_1222",1222,"1990_1364",1364,8,20,12,9,20,11,1,"Lose"
"288","1990_1112_1378",1990,137,"1990_1112",1112,"1990_1378",1378,2,1,-1,15,20,5,13,"Win"
"289","1990_1247_1379",1990,136,"1990_1247",1247,"1990_1379",1379,4,8,4,13,20,7,9,"Win"
"290","1990_1181_1385",1990,139,"1990_1181",1181,"1990_1385",1385,3,2,-1,6,20,14,3,"Win"
"291","1990_1164_1393",1990,137,"1990_1164",1164,"1990_1393",1393,15,20,5,2,2,0,-13,"Lose"
"292","1990_1278_1393",1990,144,"1990_1278",1278,"1990_1393",1393,6,11,5,2,2,0,-4,"Win"
"293","1990_1385_1396",1990,137,"1990_1385",1385,"1990_1396",1396,6,20,14,11,20,9,5,"Win"
"294","1990_1208_1400",1990,137,"1990_1208",1208,"1990_1400",1400,7,20,13,10,11,1,3,"Lose"
"295","1990_1345_1400",1990,139,"1990_1345",1345,"1990_1400",1400,2,20,18,10,11,1,8,"Lose"
"296","1990_1116_1400",1990,145,"1990_1116",1116,"1990_1400",1400,4,5,1,10,11,1,6,"Win"
"297","1990_1328_1406",1990,136,"1990_1328",1328,"1990_1406",1406,1,1,0,16,20,4,15,"Win"
"298","1990_1207_1411",1990,137,"1990_1207",1207,"1990_1411",1411,3,1,-2,14,20,6,11,"Win"
"299","1990_1412_1417",1990,137,"1990_1412",1412,"1990_1417",1417,10,20,10,7,7,0,-3,"Lose"
"300","1990_1181_1417",1990,143,"1990_1181",1181,"1990_1417",1417,3,2,-1,7,7,0,4,"Win"
"301","1990_1242_1417",1990,139,"1990_1242",1242,"1990_1417",1417,2,20,18,7,7,0,5,"Lose"
"302","1990_1345_1419",1990,137,"1990_1345",1345,"1990_1419",1419,2,20,18,15,20,5,13,"Win"
"303","1990_1114_1424",1990,136,"1990_1114",1114,"1990_1424",1424,16,13,-3,1,4,3,-15,"Lose"
"304","1990_1210_1424",1990,152,"1990_1210",1210,"1990_1424",1424,4,6,2,1,4,3,-3,"Lose"
"305","1990_1123_1424",1990,144,"1990_1123",1123,"1990_1424",1424,12,9,-3,1,4,3,-11,"Lose"
"306","1990_1181_1424",1990,154,"1990_1181",1181,"1990_1424",1424,3,2,-1,1,4,3,-2,"Lose"
"307","1990_1326_1424",1990,138,"1990_1326",1326,"1990_1424",1424,8,20,12,1,4,3,-7,"Lose"
"308","1990_1258_1424",1990,146,"1990_1258",1258,"1990_1424",1424,11,12,1,1,4,3,-10,"Lose"
"309","1990_1278_1431",1990,137,"1990_1278",1278,"1990_1431",1431,6,11,5,11,7,-4,5,"Win"
"310","1990_1261_1437",1990,136,"1990_1261",1261,"1990_1437",1437,5,10,5,12,20,8,7,"Win"
"311","1990_1393_1438",1990,139,"1990_1393",1393,"1990_1438",1438,2,2,0,7,5,-2,5,"Win"
"312","1990_1323_1438",1990,137,"1990_1323",1323,"1990_1438",1438,10,9,-1,7,5,-2,-3,"Lose"
"313","1990_1207_1462",1990,139,"1990_1207",1207,"1990_1462",1462,3,1,-2,6,14,8,3,"Lose"
"314","1990_1243_1462",1990,137,"1990_1243",1243,"1990_1462",1462,11,6,-5,6,14,8,-5,"Lose"
"315","1990_1400_1462",1990,143,"1990_1400",1400,"1990_1462",1462,10,11,1,6,14,8,-4,"Win"
"316","1991_1104_1116",1991,143,"1991_1104",1104,"1991_1116",1116,4,7,3,1,4,3,-3,"Lose"
"317","1991_1113_1116",1991,139,"1991_1113",1113,"1991_1116",1116,8,20,12,1,4,3,-7,"Lose"
"318","1991_1112_1140",1991,138,"1991_1112",1112,"1991_1140",1140,2,2,0,10,12,2,8,"Win"
"319","1991_1163_1181",1991,144,"1991_1163",1163,"1991_1181",1181,11,1,-10,2,3,1,-9,"Lose"
"320","1991_1116_1209",1991,137,"1991_1116",1116,"1991_1209",1209,1,4,3,16,20,4,15,"Win"
"321","1991_1177_1210",1991,137,"1991_1177",1177,"1991_1210",1210,9,20,11,8,4,-4,-1,"Lose"
"322","1991_1157_1231",1991,136,"1991_1157",1157,"1991_1231",1231,15,20,5,2,8,6,-13,"Lose"
"323","1991_1199_1231",1991,138,"1991_1199",1199,"1991_1231",1231,7,20,13,2,8,6,-5,"Lose"
"324","1991_1190_1234",1991,136,"1991_1190",1190,"1991_1234",1234,10,13,3,7,20,13,-3,"Lose"
"325","1991_1181_1234",1991,138,"1991_1181",1181,"1991_1234",1234,2,3,1,7,20,13,5,"Win"
"326","1991_1116_1242",1991,145,"1991_1116",1116,"1991_1242",1242,1,4,3,3,2,-1,2,"Lose"
"327","1991_1231_1242",1991,143,"1991_1231",1231,"1991_1242",1242,2,8,6,3,2,-1,1,"Lose"
"328","1991_1181_1242",1991,154,"1991_1181",1181,"1991_1242",1242,2,3,1,3,2,-1,1,"Win"
"329","1991_1163_1261",1991,136,"1991_1163",1163,"1991_1261",1261,11,1,-10,6,5,-1,-5,"Win"
"330","1991_1185_1280",1991,137,"1991_1185",1185,"1991_1280",1280,12,20,8,5,20,15,-7,"Win"
"331","1991_1104_1293",1991,137,"1991_1104",1104,"1991_1293",1293,4,7,3,13,16,3,9,"Win"
"332","1991_1166_1308",1991,136,"1991_1166",1166,"1991_1308",1308,11,20,9,6,6,0,-5,"Win"
"333","1991_1242_1309",1991,136,"1991_1242",1242,"1991_1309",1309,3,2,-1,14,20,6,11,"Win"
"334","1991_1185_1314",1991,144,"1991_1185",1185,"1991_1314",1314,12,20,8,1,8,7,-11,"Lose"
"335","1991_1242_1314",1991,152,"1991_1242",1242,"1991_1314",1314,3,2,-1,1,8,7,-2,"Win"
"336","1991_1314_1318",1991,137,"1991_1314",1314,"1991_1318",1318,1,8,7,16,20,4,15,"Win"
"337","1991_1210_1326",1991,139,"1991_1210",1210,"1991_1326",1326,8,4,-4,1,8,7,-7,"Lose"
"338","1991_1301_1329",1991,138,"1991_1301",1301,"1991_1329",1329,6,20,14,3,20,17,-3,"Lose"
"339","1991_1307_1329",1991,136,"1991_1307",1307,"1991_1329",1329,14,20,6,3,20,17,-11,"Lose"
"340","1991_1185_1336",1991,139,"1991_1185",1185,"1991_1336",1336,12,20,8,13,20,7,1,"Win"
"341","1991_1242_1338",1991,138,"1991_1242",1242,"1991_1338",1338,3,2,-1,6,20,14,3,"Win"
"342","1991_1208_1338",1991,136,"1991_1208",1208,"1991_1338",1338,11,7,-4,6,20,14,-5,"Lose"
"343","1991_1113_1353",1991,137,"1991_1113",1113,"1991_1353",1353,8,20,12,9,20,11,1,"Win"
"344","1991_1112_1371",1991,143,"1991_1112",1112,"1991_1371",1371,2,2,0,3,20,17,1,"Lose"
"345","1991_1337_1371",1991,136,"1991_1337",1337,"1991_1371",1371,14,20,6,3,20,17,-11,"Lose"
"346","1991_1166_1371",1991,138,"1991_1166",1166,"1991_1371",1371,11,20,9,3,20,17,-8,"Lose"
"347","1991_1301_1379",1991,136,"1991_1301",1301,"1991_1379",1379,6,20,14,11,13,2,5,"Win"
"348","1991_1112_1384",1991,136,"1991_1112",1112,"1991_1384",1384,2,2,0,15,20,5,13,"Win"
"349","1991_1326_1385",1991,144,"1991_1326",1326,"1991_1385",1385,1,8,7,4,6,2,3,"Lose"
"350","1991_1181_1385",1991,146,"1991_1181",1181,"1991_1385",1385,2,3,1,4,6,2,2,"Win"
"351","1991_1296_1385",1991,137,"1991_1296",1296,"1991_1385",1385,13,20,7,4,6,2,-9,"Lose"
"352","1991_1350_1393",1991,136,"1991_1350",1350,"1991_1393",1393,15,14,-1,2,2,0,-13,"Win"
"353","1991_1314_1396",1991,146,"1991_1314",1314,"1991_1396",1396,1,8,7,10,11,1,9,"Win"
"354","1991_1329_1396",1991,144,"1991_1329",1329,"1991_1396",1396,3,20,17,10,11,1,7,"Lose"
"355","1991_1350_1396",1991,138,"1991_1350",1350,"1991_1396",1396,15,14,-1,10,11,1,-5,"Lose"
"356","1991_1345_1396",1991,136,"1991_1345",1345,"1991_1396",1396,7,2,-5,10,11,1,3,"Lose"
"357","1991_1385_1400",1991,139,"1991_1385",1385,"1991_1400",1400,4,6,2,5,10,5,1,"Win"
"358","1991_1389_1400",1991,137,"1991_1389",1389,"1991_1400",1400,12,20,8,5,10,5,-7,"Lose"
"359","1991_1326_1406",1991,137,"1991_1326",1326,"1991_1406",1406,1,8,7,16,16,0,15,"Win"
"360","1991_1336_1417",1991,137,"1991_1336",1336,"1991_1417",1417,13,20,7,4,7,3,-9,"Win"
"361","1991_1181_1419",1991,136,"1991_1181",1181,"1991_1419",1419,2,3,1,15,15,0,13,"Win"
"362","1991_1181_1424",1991,152,"1991_1181",1181,"1991_1424",1424,2,3,1,1,1,0,-1,"Win"
"363","1991_1371_1424",1991,145,"1991_1371",1371,"1991_1424",1424,3,20,17,1,1,0,-2,"Lose"
"364","1991_1285_1424",1991,137,"1991_1285",1285,"1991_1424",1424,16,20,4,1,1,0,-15,"Lose"
"365","1991_1207_1424",1991,139,"1991_1207",1207,"1991_1424",1424,8,3,-5,1,1,0,-7,"Lose"
"366","1991_1199_1425",1991,136,"1991_1199",1199,"1991_1425",1425,7,20,13,10,20,10,3,"Win"
"367","1991_1277_1428",1991,139,"1991_1277",1277,"1991_1428",1428,5,1,-4,4,20,16,-1,"Lose"
"368","1991_1375_1428",1991,137,"1991_1375",1375,"1991_1428",1428,13,20,7,4,20,16,-9,"Lose"
"369","1991_1424_1428",1991,143,"1991_1424",1424,"1991_1428",1428,1,1,0,4,20,16,3,"Win"
"370","1991_1207_1435",1991,137,"1991_1207",1207,"1991_1435",1435,8,3,-5,9,20,11,1,"Win"
"371","1991_1314_1437",1991,139,"1991_1314",1314,"1991_1437",1437,1,8,7,9,12,3,8,"Win"
"372","1991_1343_1437",1991,137,"1991_1343",1343,"1991_1437",1437,8,13,5,9,12,3,1,"Lose"
"373","1991_1140_1438",1991,136,"1991_1140",1140,"1991_1438",1438,10,12,2,7,7,0,-3,"Win"
"374","1991_1256_1448",1991,137,"1991_1256",1256,"1991_1448",1448,12,20,8,5,20,15,-7,"Lose"
"375","1991_1104_1448",1991,139,"1991_1104",1104,"1991_1448",1448,4,7,3,5,20,15,1,"Win"
"376","1991_1277_1453",1991,137,"1991_1277",1277,"1991_1453",1453,5,1,-4,12,20,8,7,"Win"
"377","1991_1304_1462",1991,136,"1991_1304",1304,"1991_1462",1462,3,20,17,14,6,-8,11,"Lose"
"378","1991_1163_1462",1991,138,"1991_1163",1163,"1991_1462",1462,11,1,-10,14,6,-8,3,"Win"
"379","1992_1153_1174",1992,137,"1992_1153",1153,"1992_1174",1174,4,20,16,13,20,7,9,"Win"
"380","1992_1144_1181",1992,136,"1992_1144",1144,"1992_1181",1181,16,20,4,1,2,1,-15,"Lose"
"381","1992_1112_1190",1992,137,"1992_1112",1112,"1992_1190",1190,3,2,-1,14,10,-4,11,"Lose"
"382","1992_1199_1207",1992,138,"1992_1199",1199,"1992_1207",1207,3,7,4,6,8,2,3,"Win"
"383","1992_1210_1222",1992,136,"1992_1210",1210,"1992_1222",1222,7,8,1,10,20,10,3,"Win"
"384","1992_1183_1231",1992,136,"1992_1183",1183,"1992_1231",1231,15,20,5,2,2,0,-13,"Lose"
"385","1992_1199_1231",1992,143,"1992_1199",1199,"1992_1231",1231,3,7,4,2,2,0,-1,"Lose"
"386","1992_1181_1231",1992,152,"1992_1181",1181,"1992_1231",1231,1,2,1,2,2,0,1,"Win"
"387","1992_1181_1234",1992,138,"1992_1181",1181,"1992_1234",1234,1,2,1,9,7,-2,8,"Win"
"388","1992_1150_1235",1992,137,"1992_1150",1150,"1992_1235",1235,7,20,13,10,20,10,3,"Lose"
"389","1992_1224_1242",1992,137,"1992_1224",1224,"1992_1242",1242,16,20,4,1,3,2,-15,"Lose"
"390","1992_1181_1246",1992,145,"1992_1181",1181,"1992_1246",1246,1,2,1,2,20,18,1,"Win"
"391","1992_1235_1246",1992,139,"1992_1235",1235,"1992_1246",1246,10,20,10,2,20,18,-8,"Lose"
"392","1992_1140_1261",1992,136,"1992_1140",1140,"1992_1261",1261,10,10,0,7,6,-1,-3,"Lose"
"393","1992_1231_1261",1992,138,"1992_1231",1231,"1992_1261",1261,2,2,0,7,6,-1,5,"Win"
"394","1992_1246_1269",1992,143,"1992_1246",1246,"1992_1269",1269,2,20,18,3,20,17,1,"Win"
"395","1992_1200_1269",1992,137,"1992_1200",1200,"1992_1269",1269,14,20,6,3,20,17,-11,"Lose"
"396","1992_1116_1272",1992,138,"1992_1116",1116,"1992_1272",1272,3,1,-2,6,20,14,3,"Lose"
"397","1992_1210_1272",1992,144,"1992_1210",1210,"1992_1272",1272,7,8,1,6,20,14,-1,"Lose"
"398","1992_1153_1272",1992,146,"1992_1153",1153,"1992_1272",1272,4,20,16,6,20,14,2,"Win"
"399","1992_1181_1276",1992,154,"1992_1181",1181,"1992_1276",1276,1,2,1,6,20,14,5,"Win"
"400","1992_1153_1276",1992,152,"1992_1153",1153,"1992_1276",1276,4,20,16,6,20,14,2,"Lose"
"401","1992_1190_1276",1992,139,"1992_1190",1190,"1992_1276",1276,14,10,-4,6,20,14,-8,"Lose"
"402","1992_1153_1277",1992,139,"1992_1153",1153,"1992_1277",1277,4,20,16,5,5,0,1,"Win"
"403","1992_1277_1283",1992,137,"1992_1277",1277,"1992_1283",1283,5,5,0,12,20,8,7,"Win"
"404","1992_1199_1285",1992,136,"1992_1199",1199,"1992_1285",1285,3,7,4,14,16,2,11,"Win"
"405","1992_1116_1293",1992,136,"1992_1116",1116,"1992_1293",1293,3,1,-2,14,13,-1,11,"Win"
"406","1992_1163_1304",1992,136,"1992_1163",1163,"1992_1304",1304,9,11,2,8,3,-5,-1,"Win"
"407","1992_1177_1308",1992,137,"1992_1177",1177,"1992_1308",1308,5,9,4,12,6,-6,7,"Lose"
"408","1992_1104_1314",1992,138,"1992_1104",1104,"1992_1314",1314,5,4,-1,4,1,-3,-1,"Lose"
"409","1992_1275_1314",1992,136,"1992_1275",1275,"1992_1314",1314,13,20,7,4,1,-3,-9,"Lose"
"410","1992_1163_1326",1992,138,"1992_1163",1163,"1992_1326",1326,9,11,2,1,1,0,-8,"Lose"
"411","1992_1314_1326",1992,144,"1992_1314",1314,"1992_1326",1326,4,1,-3,1,1,0,-3,"Lose"
"412","1992_1290_1326",1992,136,"1992_1290",1290,"1992_1326",1326,16,20,4,1,1,0,-15,"Lose"
"413","1992_1276_1326",1992,146,"1992_1276",1276,"1992_1326",1326,6,20,14,1,1,0,-5,"Win"
"414","1992_1204_1329",1992,137,"1992_1204",1204,"1992_1329",1329,15,20,5,2,3,1,-13,"Lose"
"415","1992_1276_1329",1992,144,"1992_1276",1276,"1992_1329",1329,6,20,14,2,3,1,-4,"Win"
"416","1992_1246_1330",1992,137,"1992_1246",1246,"1992_1330",1330,2,20,18,15,20,5,13,"Win"
"417","1992_1272_1337",1992,136,"1992_1272",1272,"1992_1337",1337,6,20,14,11,14,3,5,"Win"
"418","1992_1181_1371",1992,143,"1992_1181",1181,"1992_1371",1371,1,2,1,4,3,-1,3,"Win"
"419","1992_1281_1371",1992,138,"1992_1281",1281,"1992_1371",1371,5,20,15,4,3,-1,-1,"Lose"
"420","1992_1247_1371",1992,136,"1992_1247",1247,"1992_1371",1371,13,20,7,4,3,-1,-9,"Lose"
"421","1992_1207_1378",1992,136,"1992_1207",1207,"1992_1378",1378,6,8,2,11,20,9,5,"Win"
"422","1992_1104_1390",1992,136,"1992_1104",1104,"1992_1390",1390,5,4,-1,12,20,8,7,"Win"
"423","1992_1269_1393",1992,139,"1992_1269",1269,"1992_1393",1393,3,20,17,6,2,-4,3,"Win"
"424","1992_1343_1393",1992,137,"1992_1343",1343,"1992_1393",1393,11,8,-3,6,2,-4,-5,"Lose"
"425","1992_1276_1396",1992,137,"1992_1276",1276,"1992_1396",1396,6,20,14,11,10,-1,5,"Win"
"426","1992_1234_1400",1992,136,"1992_1234",1234,"1992_1400",1400,9,7,-2,8,5,-3,-1,"Win"
"427","1992_1385_1408",1992,137,"1992_1385",1385,"1992_1408",1408,7,4,-3,10,20,10,3,"Lose"
"428","1992_1329_1408",1992,139,"1992_1329",1329,"1992_1408",1408,2,3,1,10,20,10,8,"Win"
"429","1992_1231_1417",1992,145,"1992_1231",1231,"1992_1417",1417,2,2,0,1,4,3,-1,"Win"
"430","1992_1308_1417",1992,143,"1992_1308",1308,"1992_1417",1417,12,6,-6,1,4,3,-11,"Lose"
"431","1992_1352_1417",1992,137,"1992_1352",1352,"1992_1417",1417,16,20,4,1,4,3,-15,"Lose"
"432","1992_1257_1417",1992,139,"1992_1257",1257,"1992_1417",1417,8,20,12,1,4,3,-7,"Lose"
"433","1992_1328_1418",1992,137,"1992_1328",1328,"1992_1418",1418,4,20,16,13,20,7,9,"Lose"
"434","1992_1308_1418",1992,139,"1992_1308",1308,"1992_1418",1418,12,6,-6,13,20,7,1,"Win"
"435","1992_1210_1425",1992,138,"1992_1210",1210,"1992_1425",1425,7,8,1,2,10,8,-5,"Win"
"436","1992_1419_1425",1992,136,"1992_1419",1419,"1992_1425",1425,15,15,0,2,10,8,-13,"Lose"
"437","1992_1242_1431",1992,139,"1992_1242",1242,"1992_1431",1431,1,3,2,9,20,11,8,"Lose"
"438","1992_1153_1431",1992,144,"1992_1153",1153,"1992_1431",1431,4,20,16,9,20,11,5,"Win"
"439","1992_1191_1431",1992,137,"1992_1191",1191,"1992_1431",1431,8,20,12,9,20,11,1,"Lose"
"440","1992_1257_1448",1992,137,"1992_1257",1257,"1992_1448",1448,8,20,12,9,5,-4,1,"Win"
"441","1992_1281_1452",1992,136,"1992_1281",1281,"1992_1452",1452,5,20,15,12,20,8,7,"Win"
"442","1993_1153_1164",1993,137,"1993_1153",1153,"1993_1164",1164,2,4,2,15,20,5,13,"Win"
"443","1993_1143_1181",1993,138,"1993_1143",1143,"1993_1181",1181,6,20,14,3,1,-2,-3,"Win"
"444","1993_1191_1199",1993,136,"1993_1191",1191,"1993_1199",1199,14,8,-6,3,3,0,-11,"Lose"
"445","1993_1116_1221",1993,136,"1993_1116",1116,"1993_1221",1221,4,3,-1,13,20,7,9,"Win"
"446","1993_1123_1242",1993,136,"1993_1123",1123,"1993_1242",1242,15,20,5,2,1,-1,-13,"Lose"
"447","1993_1143_1242",1993,143,"1993_1143",1143,"1993_1242",1242,6,20,14,2,1,-1,-4,"Lose"
"448","1993_1231_1242",1993,145,"1993_1231",1231,"1993_1242",1242,1,2,1,2,1,-1,1,"Lose"
"449","1993_1140_1242",1993,138,"1993_1140",1140,"1993_1242",1242,7,10,3,2,1,-1,-5,"Lose"
"450","1993_1199_1246",1993,145,"1993_1199",1199,"1993_1246",1246,3,3,0,1,2,1,-2,"Lose"
"451","1993_1228_1253",1993,136,"1993_1228",1228,"1993_1253",1253,6,20,14,11,20,9,5,"Win"
"452","1993_1174_1257",1993,137,"1993_1174",1174,"1993_1257",1257,13,13,0,4,8,4,-9,"Lose"
"453","1993_1231_1257",1993,143,"1993_1231",1231,"1993_1257",1257,1,2,1,4,8,4,3,"Win"
"454","1993_1143_1261",1993,136,"1993_1143",1143,"1993_1261",1261,6,20,14,11,7,-4,5,"Win"
"455","1993_1246_1276",1993,152,"1993_1246",1246,"1993_1276",1276,1,2,1,1,6,5,0,"Lose"
"456","1993_1157_1276",1993,137,"1993_1157",1157,"1993_1276",1276,16,20,4,1,6,5,-15,"Lose"
"457","1993_1203_1276",1993,144,"1993_1203",1203,"1993_1276",1276,12,20,8,1,6,5,-11,"Lose"
"458","1993_1203_1307",1993,137,"1993_1203",1203,"1993_1307",1307,12,20,8,5,20,15,-7,"Win"
"459","1993_1304_1308",1993,137,"1993_1304",1304,"1993_1308",1308,10,8,-2,7,12,5,-3,"Lose"
"460","1993_1153_1308",1993,139,"1993_1153",1153,"1993_1308",1308,2,4,2,7,12,5,5,"Win"
"461","1993_1116_1314",1993,144,"1993_1116",1116,"1993_1314",1314,4,3,-1,1,4,3,-3,"Lose"
"462","1993_1276_1314",1993,154,"1993_1276",1276,"1993_1314",1314,1,6,5,1,4,3,0,"Lose"
"463","1993_1242_1314",1993,152,"1993_1242",1242,"1993_1314",1314,2,1,-1,1,4,3,-1,"Lose"
"464","1993_1187_1314",1993,136,"1993_1187",1187,"1993_1314",1314,16,20,4,1,4,3,-15,"Lose"
"465","1993_1153_1314",1993,146,"1993_1153",1153,"1993_1314",1314,2,4,2,1,4,3,-1,"Lose"
"466","1993_1257_1329",1993,139,"1993_1257",1257,"1993_1329",1329,4,8,4,5,2,-3,1,"Win"
"467","1993_1266_1329",1993,137,"1993_1266",1266,"1993_1329",1329,12,20,8,5,2,-3,-7,"Lose"
"468","1993_1269_1335",1993,137,"1993_1269",1269,"1993_1335",1335,3,3,0,14,20,6,11,"Win"
"469","1993_1345_1348",1993,136,"1993_1345",1345,"1993_1348",1348,9,20,11,8,20,12,-1,"Lose"
"470","1993_1314_1348",1993,138,"1993_1314",1314,"1993_1348",1348,1,4,3,8,20,12,7,"Win"
"471","1993_1246_1351",1993,137,"1993_1246",1246,"1993_1351",1351,1,2,1,16,20,4,15,"Win"
"472","1993_1181_1356",1993,136,"1993_1181",1181,"1993_1356",1356,3,1,-2,14,20,6,11,"Win"
"473","1993_1112_1365",1993,136,"1993_1112",1112,"1993_1365",1365,2,3,1,15,20,5,13,"Lose"
"474","1993_1140_1374",1993,136,"1993_1140",1140,"1993_1374",1374,7,10,3,10,20,10,3,"Win"
"475","1993_1210_1380",1993,137,"1993_1210",1210,"1993_1380",1380,4,7,3,13,20,7,9,"Lose"
"476","1993_1203_1380",1993,139,"1993_1203",1203,"1993_1380",1380,12,20,8,13,20,7,1,"Win"
"477","1993_1116_1385",1993,138,"1993_1116",1116,"1993_1385",1385,4,3,-1,5,7,2,1,"Win"
"478","1993_1281_1396",1993,136,"1993_1281",1281,"1993_1396",1396,10,5,-5,7,11,4,-3,"Lose"
"479","1993_1276_1396",1993,146,"1993_1276",1276,"1993_1396",1396,1,6,5,7,11,4,6,"Win"
"480","1993_1365_1396",1993,138,"1993_1365",1365,"1993_1396",1396,15,20,5,7,11,4,-8,"Lose"
"481","1993_1371_1398",1993,136,"1993_1371",1371,"1993_1398",1398,2,4,2,15,20,5,13,"Win"
"482","1993_1385_1403",1993,136,"1993_1385",1385,"1993_1403",1403,5,7,2,12,20,8,7,"Win"
"483","1993_1199_1408",1993,138,"1993_1199",1199,"1993_1408",1408,3,3,0,11,10,-1,8,"Win"
"484","1993_1243_1408",1993,136,"1993_1243",1243,"1993_1408",1408,6,20,14,11,10,-1,5,"Lose"
"485","1993_1235_1417",1993,137,"1993_1235",1235,"1993_1417",1417,8,10,2,9,1,-8,1,"Lose"
"486","1993_1276_1417",1993,139,"1993_1276",1276,"1993_1417",1417,1,6,5,9,1,-8,8,"Win"
"487","1993_1234_1419",1993,137,"1993_1234",1234,"1993_1419",1419,4,9,5,13,15,2,9,"Win"
"488","1993_1246_1428",1993,139,"1993_1246",1246,"1993_1428",1428,1,2,1,8,20,12,7,"Win"
"489","1993_1338_1428",1993,137,"1993_1338",1338,"1993_1428",1428,9,20,11,8,20,12,-1,"Lose"
"490","1993_1129_1435",1993,136,"1993_1129",1129,"1993_1435",1435,14,20,6,3,20,17,-11,"Lose"
"491","1993_1396_1435",1993,144,"1993_1396",1396,"1993_1435",1435,7,11,4,3,20,17,-4,"Win"
"492","1993_1228_1435",1993,138,"1993_1228",1228,"1993_1435",1435,6,20,14,3,20,17,-3,"Lose"
"493","1993_1153_1438",1993,144,"1993_1153",1153,"1993_1438",1438,2,4,2,6,20,14,4,"Win"
"494","1993_1264_1438",1993,137,"1993_1264",1264,"1993_1438",1438,11,20,9,6,20,14,-5,"Lose"
"495","1993_1269_1438",1993,139,"1993_1269",1269,"1993_1438",1438,3,3,0,6,20,14,3,"Lose"
"496","1993_1371_1443",1993,138,"1993_1371",1371,"1993_1443",1443,2,4,2,7,20,13,5,"Lose"
"497","1993_1199_1443",1993,143,"1993_1199",1199,"1993_1443",1443,3,3,0,7,20,13,4,"Win"
"498","1993_1272_1443",1993,136,"1993_1272",1272,"1993_1443",1443,10,6,-4,7,20,13,-3,"Lose"
"499","1993_1234_1448",1993,139,"1993_1234",1234,"1993_1448",1448,4,9,5,5,9,4,1,"Lose"
"500","1993_1246_1448",1993,143,"1993_1246",1246,"1993_1448",1448,1,2,1,5,9,4,4,"Win"
"501","1993_1151_1448",1993,137,"1993_1151",1151,"1993_1448",1448,12,20,8,5,9,4,-7,"Lose"
"502","1993_1231_1460",1993,137,"1993_1231",1231,"1993_1460",1460,1,2,1,16,20,4,15,"Win"
"503","1993_1231_1462",1993,139,"1993_1231",1231,"1993_1462",1462,1,2,1,9,20,11,8,"Win"
"504","1993_1309_1462",1993,137,"1993_1309",1309,"1993_1462",1462,8,20,12,9,20,11,1,"Lose"
"505","1994_1112_1116",1994,152,"1994_1112",1112,"1994_1116",1116,2,2,0,1,4,3,-1,"Lose"
"506","1994_1116_1181",1994,154,"1994_1116",1116,"1994_1181",1181,1,4,3,2,3,1,1,"Win"
"507","1994_1163_1196",1994,144,"1994_1163",1163,"1994_1196",1196,2,20,18,3,20,17,1,"Lose"
"508","1994_1181_1196",1994,152,"1994_1181",1181,"1994_1196",1196,2,3,1,3,20,17,1,"Win"
"509","1994_1130_1196",1994,146,"1994_1130",1130,"1994_1196",1196,9,20,11,3,20,17,-6,"Lose"
"510","1994_1163_1203",1994,138,"1994_1163",1163,"1994_1203",1203,2,20,18,10,12,2,8,"Win"
"511","1994_1116_1207",1994,139,"1994_1116",1116,"1994_1207",1207,1,4,3,9,20,11,8,"Win"
"512","1994_1207_1228",1994,137,"1994_1207",1207,"1994_1228",1228,9,20,11,8,6,-2,-1,"Win"
"513","1994_1130_1231",1994,144,"1994_1130",1130,"1994_1231",1231,9,20,11,5,1,-4,-4,"Win"
"514","1994_1196_1241",1994,136,"1994_1196",1196,"1994_1241",1241,3,20,17,14,20,6,11,"Win"
"515","1994_1151_1242",1994,136,"1994_1151",1151,"1994_1242",1242,13,12,-1,4,2,-2,-9,"Lose"
"516","1994_1129_1257",1994,137,"1994_1129",1129,"1994_1257",1257,14,14,0,3,4,1,-11,"Lose"
"517","1994_1112_1257",1994,143,"1994_1112",1112,"1994_1257",1257,2,2,0,3,4,1,1,"Win"
"518","1994_1112_1259",1994,137,"1994_1112",1112,"1994_1259",1259,2,2,0,15,20,5,13,"Win"
"519","1994_1246_1266",1994,139,"1994_1246",1246,"1994_1266",1266,3,1,-2,6,12,6,3,"Lose"
"520","1994_1181_1266",1994,143,"1994_1181",1181,"1994_1266",1266,2,3,1,6,12,6,4,"Win"
"521","1994_1268_1269",1994,138,"1994_1268",1268,"1994_1269",1269,10,20,10,2,3,1,-8,"Win"
"522","1994_1116_1276",1994,146,"1994_1116",1116,"1994_1276",1276,1,4,3,3,1,-2,2,"Win"
"523","1994_1268_1276",1994,144,"1994_1268",1268,"1994_1276",1276,10,20,10,3,1,-2,-7,"Lose"
"524","1994_1181_1277",1994,139,"1994_1181",1181,"1994_1277",1277,2,3,1,7,20,13,5,"Win"
"525","1994_1257_1278",1994,139,"1994_1257",1257,"1994_1278",1278,3,4,1,6,20,14,3,"Win"
"526","1994_1112_1281",1994,145,"1994_1112",1112,"1994_1281",1281,2,2,0,1,10,9,-1,"Win"
"527","1994_1281_1298",1994,136,"1994_1281",1281,"1994_1298",1298,1,10,9,16,20,4,15,"Win"
"528","1994_1116_1299",1994,137,"1994_1116",1116,"1994_1299",1299,1,4,3,16,20,4,15,"Win"
"529","1994_1251_1314",1994,137,"1994_1251",1251,"1994_1314",1314,16,20,4,1,1,0,-15,"Lose"
"530","1994_1130_1314",1994,139,"1994_1130",1130,"1994_1314",1314,9,20,11,1,1,0,-8,"Win"
"531","1994_1231_1325",1994,137,"1994_1231",1231,"1994_1325",1325,5,1,-4,12,20,8,7,"Win"
"532","1994_1308_1329",1994,137,"1994_1308",1308,"1994_1329",1329,13,7,-6,4,5,1,-9,"Lose"
"533","1994_1196_1335",1994,138,"1994_1196",1196,"1994_1335",1335,3,20,17,11,14,3,8,"Win"
"534","1994_1304_1335",1994,136,"1994_1304",1304,"1994_1335",1335,6,10,4,11,14,3,5,"Lose"
"535","1994_1276_1337",1994,136,"1994_1276",1276,"1994_1337",1337,3,1,-2,14,20,6,11,"Win"
"536","1994_1104_1344",1994,136,"1994_1104",1104,"1994_1344",1344,9,20,11,8,20,12,-1,"Win"
"537","1994_1104_1345",1994,138,"1994_1104",1104,"1994_1345",1345,9,20,11,1,9,8,-8,"Lose"
"538","1994_1181_1345",1994,145,"1994_1181",1181,"1994_1345",1345,2,3,1,1,9,8,-1,"Win"
"539","1994_1242_1345",1994,143,"1994_1242",1242,"1994_1345",1345,4,2,-2,1,9,8,-3,"Lose"
"540","1994_1163_1351",1994,136,"1994_1163",1163,"1994_1351",1351,2,20,18,15,16,1,13,"Win"
"541","1994_1278_1356",1994,137,"1994_1278",1278,"1994_1356",1356,6,20,14,11,14,3,5,"Win"
"542","1994_1277_1371",1994,137,"1994_1277",1277,"1994_1371",1371,7,20,13,10,2,-8,3,"Win"
"543","1994_1268_1387",1994,136,"1994_1268",1268,"1994_1387",1387,10,20,10,7,20,13,-3,"Win"
"544","1994_1218_1393",1994,136,"1994_1218",1218,"1994_1393",1393,13,20,7,4,20,16,-9,"Lose"
"545","1994_1281_1393",1994,143,"1994_1281",1281,"1994_1393",1393,1,10,9,4,20,16,3,"Win"
"546","1994_1231_1396",1994,139,"1994_1231",1231,"1994_1396",1396,5,1,-4,4,7,3,-1,"Win"
"547","1994_1180_1396",1994,137,"1994_1180",1180,"1994_1396",1396,13,20,7,4,7,3,-9,"Lose"
"548","1994_1246_1398",1994,137,"1994_1246",1246,"1994_1398",1398,3,1,-2,14,15,1,11,"Win"
"549","1994_1276_1400",1994,138,"1994_1276",1276,"1994_1400",1400,3,1,-2,6,20,14,3,"Win"
"550","1994_1269_1402",1994,136,"1994_1269",1269,"1994_1402",1402,2,3,1,15,20,5,13,"Win"
"551","1994_1329_1409",1994,139,"1994_1329",1329,"1994_1409",1409,4,5,1,12,20,8,8,"Lose"
"552","1994_1116_1409",1994,144,"1994_1116",1116,"1994_1409",1409,1,4,3,12,20,8,11,"Win"
"553","1994_1181_1411",1994,137,"1994_1181",1181,"1994_1411",1411,2,3,1,15,20,5,13,"Win"
"554","1994_1203_1412",1994,136,"1994_1203",1203,"1994_1412",1412,10,12,2,7,20,13,-3,"Win"
"555","1994_1345_1416",1994,136,"1994_1345",1345,"1994_1416",1416,1,9,8,16,20,4,15,"Win"
"556","1994_1409_1417",1994,137,"1994_1409",1409,"1994_1417",1417,12,20,8,5,9,4,-7,"Win"
"557","1994_1266_1418",1994,137,"1994_1266",1266,"1994_1418",1418,6,12,6,11,20,9,5,"Win"
"558","1994_1112_1438",1994,139,"1994_1112",1112,"1994_1438",1438,2,2,0,7,6,-1,5,"Win"
"559","1994_1307_1438",1994,137,"1994_1307",1307,"1994_1438",1438,10,5,-5,7,6,-1,-3,"Lose"
"560","1994_1400_1443",1994,136,"1994_1400",1400,"1994_1443",1443,6,20,14,11,7,-4,5,"Win"
"561","1994_1242_1448",1994,138,"1994_1242",1242,"1994_1448",1448,4,2,-2,5,5,0,1,"Win"
"562","1994_1158_1448",1994,136,"1994_1158",1158,"1994_1448",1448,12,20,8,5,5,0,-7,"Lose"
"563","1994_1130_1450",1994,137,"1994_1130",1130,"1994_1450",1450,9,20,11,8,20,12,-1,"Win"
"564","1994_1143_1453",1994,136,"1994_1143",1143,"1994_1453",1453,5,6,1,12,20,8,7,"Lose"
"565","1994_1393_1453",1994,138,"1994_1393",1393,"1994_1453",1453,4,20,16,12,20,8,8,"Win"
"566","1994_1281_1458",1994,138,"1994_1281",1281,"1994_1458",1458,1,10,9,9,20,11,8,"Win"
"567","1994_1153_1458",1994,136,"1994_1153",1153,"1994_1458",1458,8,2,-6,9,20,11,1,"Lose"
"568","1995_1113_1123",1995,136,"1995_1113",1113,"1995_1123",1123,5,20,15,12,20,8,7,"Win"
"569","1995_1153_1163",1995,138,"1995_1153",1153,"1995_1163",1163,7,8,1,2,2,0,-5,"Lose"
"570","1995_1151_1163",1995,136,"1995_1151",1151,"1995_1163",1163,15,13,-2,2,2,0,-13,"Lose"
"571","1995_1196_1235",1995,137,"1995_1196",1196,"1995_1235",1235,10,3,-7,7,20,13,-3,"Lose"
"572","1995_1159_1242",1995,136,"1995_1159",1159,"1995_1242",1242,16,20,4,1,4,3,-15,"Lose"
"573","1995_1113_1246",1995,143,"1995_1113",1113,"1995_1246",1246,5,20,15,1,3,2,-4,"Lose"
"574","1995_1113_1264",1995,138,"1995_1113",1113,"1995_1264",1264,5,20,15,13,20,7,8,"Win"
"575","1995_1163_1268",1995,143,"1995_1163",1163,"1995_1268",1268,2,2,0,3,10,7,1,"Win"
"576","1995_1211_1268",1995,136,"1995_1211",1211,"1995_1268",1268,14,20,6,3,10,7,-11,"Lose"
"577","1995_1116_1272",1995,144,"1995_1116",1116,"1995_1272",1272,2,1,-1,6,20,14,4,"Win"
"578","1995_1257_1272",1995,137,"1995_1257",1257,"1995_1272",1272,11,3,-8,6,20,14,-5,"Lose"
"579","1995_1112_1275",1995,136,"1995_1112",1112,"1995_1275",1275,5,2,-3,12,20,8,7,"Lose"
"580","1995_1231_1281",1995,137,"1995_1231",1231,"1995_1281",1281,9,5,-4,8,1,-7,-1,"Lose"
"581","1995_1246_1291",1995,136,"1995_1246",1246,"1995_1291",1291,1,3,2,16,20,4,15,"Win"
"582","1995_1293_1314",1995,137,"1995_1293",1293,"1995_1314",1314,15,20,5,2,1,-1,-13,"Lose"
"583","1995_1207_1314",1995,143,"1995_1207",1207,"1995_1314",1314,6,9,3,2,1,-1,-4,"Lose"
"584","1995_1235_1314",1995,139,"1995_1235",1235,"1995_1314",1314,7,20,13,2,1,-1,-5,"Lose"
"585","1995_1246_1314",1995,145,"1995_1246",1246,"1995_1314",1314,1,3,2,2,1,-1,1,"Lose"
"586","1995_1116_1314",1995,152,"1995_1116",1116,"1995_1314",1314,2,1,-1,2,1,-1,0,"Win"
"587","1995_1264_1328",1995,136,"1995_1264",1264,"1995_1328",1328,13,20,7,4,20,16,-9,"Win"
"588","1995_1104_1329",1995,138,"1995_1104",1104,"1995_1329",1329,5,9,4,4,4,0,-1,"Lose"
"589","1995_1269_1329",1995,146,"1995_1269",1269,"1995_1329",1329,2,2,0,4,4,0,2,"Lose"
"590","1995_1180_1329",1995,136,"1995_1180",1180,"1995_1329",1329,13,13,0,4,4,0,-9,"Lose"
"591","1995_1104_1335",1995,136,"1995_1104",1104,"1995_1335",1335,5,9,4,12,11,-1,7,"Win"
"592","1995_1272_1345",1995,139,"1995_1272",1272,"1995_1345",1345,6,20,14,3,1,-2,-3,"Win"
"593","1995_1280_1365",1995,137,"1995_1280",1280,"1995_1365",1365,5,20,15,12,20,8,7,"Win"
"594","1995_1278_1387",1995,136,"1995_1278",1278,"1995_1387",1387,8,6,-2,9,7,-2,1,"Lose"
"595","1995_1269_1389",1995,137,"1995_1269",1269,"1995_1389",1389,2,2,0,15,20,5,13,"Win"
"596","1995_1150_1390",1995,137,"1995_1150",1150,"1995_1390",1390,7,20,13,10,20,10,3,"Lose"
"597","1995_1269_1390",1995,139,"1995_1269",1269,"1995_1390",1390,2,2,0,10,20,10,8,"Win"
"598","1995_1356_1393",1995,137,"1995_1356",1356,"1995_1393",1393,10,11,1,7,4,-3,-3,"Lose"
"599","1995_1116_1393",1995,139,"1995_1116",1116,"1995_1393",1393,2,1,-1,7,4,-3,5,"Win"
"600","1995_1153_1396",1995,136,"1995_1153",1153,"1995_1396",1396,7,8,1,10,4,-6,3,"Win"
"601","1995_1268_1400",1995,138,"1995_1268",1268,"1995_1400",1400,3,10,7,11,6,-5,8,"Win"
"602","1995_1332_1400",1995,136,"1995_1332",1332,"1995_1400",1400,6,20,14,11,6,-5,5,"Lose"
"603","1995_1140_1408",1995,136,"1995_1140",1140,"1995_1408",1408,8,20,12,9,20,11,1,"Lose"
"604","1995_1246_1408",1995,138,"1995_1246",1246,"1995_1408",1408,1,3,2,9,20,11,8,"Win"
"605","1995_1228_1409",1995,137,"1995_1228",1228,"1995_1409",1409,11,8,-3,6,12,6,-5,"Lose"
"606","1995_1269_1409",1995,144,"1995_1269",1269,"1995_1409",1409,2,2,0,6,12,6,4,"Win"
"607","1995_1330_1409",1995,139,"1995_1330",1330,"1995_1409",1409,14,20,6,6,12,6,-8,"Lose"
"608","1995_1116_1411",1995,137,"1995_1116",1116,"1995_1411",1411,2,1,-1,15,15,0,13,"Win"
"609","1995_1281_1417",1995,139,"1995_1281",1281,"1995_1417",1417,8,1,-7,1,5,4,-7,"Lose"
"610","1995_1198_1417",1995,137,"1995_1198",1198,"1995_1417",1417,16,20,4,1,5,4,-15,"Lose"
"611","1995_1116_1417",1995,154,"1995_1116",1116,"1995_1417",1417,2,1,-1,1,5,4,-1,"Lose"
"612","1995_1280_1417",1995,143,"1995_1280",1280,"1995_1417",1417,5,20,15,1,5,4,-4,"Lose"
"613","1995_1329_1417",1995,152,"1995_1329",1329,"1995_1417",1417,4,4,0,1,5,4,-3,"Lose"
"614","1995_1163_1417",1995,145,"1995_1163",1163,"1995_1417",1417,2,2,0,1,5,4,-1,"Lose"
"615","1995_1253_1428",1995,137,"1995_1253",1253,"1995_1428",1428,13,20,7,4,20,16,-9,"Lose"
"616","1995_1280_1428",1995,139,"1995_1280",1280,"1995_1428",1428,5,20,15,4,20,16,-1,"Win"
"617","1995_1330_1437",1995,137,"1995_1330",1330,"1995_1437",1437,14,20,6,3,20,17,-11,"Win"
"618","1995_1311_1438",1995,136,"1995_1311",1311,"1995_1438",1438,13,20,7,4,7,3,-9,"Lose"
"619","1995_1242_1438",1995,144,"1995_1242",1242,"1995_1438",1438,1,4,3,4,7,3,3,"Lose"
"620","1995_1275_1438",1995,138,"1995_1275",1275,"1995_1438",1438,12,20,8,4,7,3,-8,"Lose"
"621","1995_1116_1438",1995,146,"1995_1116",1116,"1995_1438",1438,2,1,-1,4,7,3,2,"Win"
"622","1995_1242_1443",1995,138,"1995_1242",1242,"1995_1443",1443,1,4,3,8,11,3,7,"Win"
"623","1995_1276_1443",1995,136,"1995_1276",1276,"1995_1443",1443,9,3,-6,8,11,3,-1,"Lose"
"624","1995_1329_1448",1995,144,"1995_1329",1329,"1995_1448",1448,4,4,0,1,5,4,-3,"Win"
"625","1995_1387_1448",1995,138,"1995_1387",1387,"1995_1448",1448,9,7,-2,1,5,4,-8,"Lose"
"626","1995_1299_1448",1995,136,"1995_1299",1299,"1995_1448",1448,16,16,0,1,5,4,-15,"Lose"
"627","1995_1277_1451",1995,137,"1995_1277",1277,"1995_1451",1451,3,7,4,14,20,6,11,"Lose"
"628","1995_1207_1451",1995,139,"1995_1207",1207,"1995_1451",1451,6,9,3,14,20,6,8,"Win"
"629","1995_1345_1453",1995,137,"1995_1345",1345,"1995_1453",1453,3,1,-2,14,12,-2,11,"Win"
"630","1995_1207_1462",1995,137,"1995_1207",1207,"1995_1462",1462,6,9,3,11,20,9,5,"Win"
"631","1996_1159_1163",1996,136,"1996_1159",1159,"1996_1163",1163,16,16,0,1,2,1,-15,"Lose"
"632","1996_1163_1185",1996,138,"1996_1163",1163,"1996_1185",1185,1,2,1,9,20,11,8,"Win"
"633","1996_1181_1185",1996,136,"1996_1181",1181,"1996_1185",1185,8,20,12,9,20,11,1,"Lose"
"634","1996_1155_1208",1996,136,"1996_1155",1155,"1996_1208",1208,9,20,11,8,20,12,-1,"Lose"
"635","1996_1130_1210",1996,139,"1996_1130",1130,"1996_1210",1210,11,20,9,3,20,17,-8,"Lose"
"636","1996_1122_1210",1996,137,"1996_1122",1122,"1996_1210",1210,14,20,6,3,20,17,-11,"Lose"
"637","1996_1153_1210",1996,144,"1996_1153",1153,"1996_1210",1210,2,7,5,3,20,17,1,"Win"
"638","1996_1130_1231",1996,137,"1996_1130",1130,"1996_1231",1231,11,20,9,6,9,3,-5,"Win"
"639","1996_1112_1234",1996,139,"1996_1112",1112,"1996_1234",1234,3,5,2,6,20,14,3,"Win"
"640","1996_1203_1234",1996,137,"1996_1203",1203,"1996_1234",1234,11,20,9,6,20,14,-5,"Lose"
"641","1996_1143_1235",1996,136,"1996_1143",1143,"1996_1235",1235,12,20,8,5,7,2,-7,"Lose"
"642","1996_1112_1242",1996,144,"1996_1112",1112,"1996_1242",1242,3,5,2,2,1,-1,-1,"Lose"
"643","1996_1116_1266",1996,138,"1996_1116",1116,"1996_1266",1266,12,2,-10,4,20,16,-8,"Win"
"644","1996_1116_1269",1996,143,"1996_1116",1116,"1996_1269",1269,12,2,-10,1,2,1,-11,"Lose"
"645","1996_1246_1269",1996,152,"1996_1246",1246,"1996_1269",1269,1,1,0,1,2,1,0,"Win"
"646","1996_1207_1269",1996,145,"1996_1207",1207,"1996_1269",1269,2,6,4,1,2,1,-1,"Lose"
"647","1996_1180_1272",1996,136,"1996_1180",1180,"1996_1272",1272,12,13,1,5,6,1,-7,"Win"
"648","1996_1153_1280",1996,146,"1996_1153",1153,"1996_1280",1280,2,7,5,5,5,0,3,"Lose"
"649","1996_1163_1280",1996,144,"1996_1163",1163,"1996_1280",1280,1,2,1,5,5,0,4,"Lose"
"650","1996_1266_1284",1996,136,"1996_1266",1266,"1996_1284",1284,4,20,16,13,20,7,9,"Win"
"651","1996_1207_1290",1996,137,"1996_1207",1207,"1996_1290",1290,2,6,4,15,20,5,13,"Win"
"652","1996_1207_1307",1996,139,"1996_1207",1207,"1996_1307",1307,2,6,4,7,20,13,5,"Win"
"653","1996_1243_1307",1996,137,"1996_1243",1243,"1996_1307",1307,10,20,10,7,20,13,-3,"Lose"
"654","1996_1309_1314",1996,137,"1996_1309",1309,"1996_1314",1314,11,20,9,6,2,-4,-5,"Lose"
"655","1996_1116_1336",1996,136,"1996_1116",1116,"1996_1336",1336,12,2,-10,5,20,15,-7,"Win"
"656","1996_1280_1343",1996,138,"1996_1280",1280,"1996_1343",1343,5,5,0,13,20,7,8,"Win"
"657","1996_1208_1345",1996,138,"1996_1208",1208,"1996_1345",1345,8,20,12,1,3,2,-7,"Win"
"658","1996_1242_1354",1996,137,"1996_1242",1242,"1996_1354",1354,2,1,-1,15,20,5,13,"Win"
"659","1996_1246_1363",1996,136,"1996_1246",1246,"1996_1363",1363,1,1,0,16,20,4,15,"Win"
"660","1996_1268_1365",1996,137,"1996_1268",1268,"1996_1365",1365,7,3,-4,10,12,2,3,"Lose"
"661","1996_1242_1365",1996,139,"1996_1242",1242,"1996_1365",1365,2,1,-1,10,12,2,8,"Win"
"662","1996_1269_1390",1996,138,"1996_1269",1269,"1996_1390",1390,1,2,1,9,10,1,8,"Win"
"663","1996_1133_1390",1996,136,"1996_1133",1133,"1996_1390",1390,8,20,12,9,10,1,1,"Lose"
"664","1996_1208_1393",1996,144,"1996_1208",1208,"1996_1393",1393,8,20,12,4,7,3,-4,"Lose"
"665","1996_1180_1393",1996,138,"1996_1180",1180,"1996_1393",1393,12,13,1,4,7,3,-8,"Lose"
"666","1996_1286_1393",1996,136,"1996_1286",1286,"1996_1393",1393,13,20,7,4,7,3,-9,"Lose"
"667","1996_1280_1393",1996,152,"1996_1280",1280,"1996_1393",1393,5,5,0,4,7,3,-1,"Lose"
"668","1996_1242_1393",1996,146,"1996_1242",1242,"1996_1393",1393,2,1,-1,4,7,3,2,"Lose"
"669","1996_1246_1393",1996,154,"1996_1246",1246,"1996_1393",1393,1,1,0,4,7,3,3,"Win"
"670","1996_1153_1396",1996,139,"1996_1153",1153,"1996_1396",1396,2,7,5,7,10,3,5,"Win"
"671","1996_1328_1396",1996,137,"1996_1328",1328,"1996_1396",1396,10,4,-6,7,10,3,-3,"Lose"
"672","1996_1276_1400",1996,137,"1996_1276",1276,"1996_1400",1400,7,9,2,10,11,1,3,"Lose"
"673","1996_1296_1403",1996,137,"1996_1296",1296,"1996_1403",1403,14,20,6,3,20,17,-11,"Lose"
"674","1996_1314_1403",1996,139,"1996_1314",1314,"1996_1403",1403,6,2,-4,3,20,17,-3,"Lose"
"675","1996_1207_1403",1996,143,"1996_1207",1207,"1996_1403",1403,2,6,4,3,20,17,1,"Win"
"676","1996_1257_1409",1996,137,"1996_1257",1257,"1996_1409",1409,6,11,5,11,6,-5,5,"Win"
"677","1996_1269_1416",1996,136,"1996_1269",1269,"1996_1416",1416,1,2,1,16,20,4,15,"Win"
"678","1996_1343_1417",1996,136,"1996_1343",1343,"1996_1417",1417,13,20,7,4,1,-3,-9,"Win"
"679","1996_1153_1422",1996,137,"1996_1153",1153,"1996_1422",1422,2,7,5,15,20,5,13,"Win"
"680","1996_1145_1428",1996,136,"1996_1145",1145,"1996_1428",1428,13,20,7,4,4,0,-9,"Lose"
"681","1996_1246_1428",1996,143,"1996_1246",1246,"1996_1428",1428,1,1,0,4,4,0,3,"Win"
"682","1996_1235_1428",1996,138,"1996_1235",1235,"1996_1428",1428,5,7,2,4,4,0,-1,"Lose"
"683","1996_1280_1433",1996,136,"1996_1280",1280,"1996_1433",1433,5,5,0,12,20,8,7,"Win"
"684","1996_1112_1434",1996,137,"1996_1112",1112,"1996_1434",1434,3,5,2,14,20,6,11,"Win"
"685","1996_1257_1437",1996,139,"1996_1257",1257,"1996_1437",1437,6,11,5,3,3,0,-3,"Win"
"686","1996_1339_1437",1996,137,"1996_1339",1339,"1996_1437",1437,14,20,6,3,3,0,-11,"Lose"
"687","1996_1246_1439",1996,138,"1996_1246",1246,"1996_1439",1439,1,1,0,9,20,11,8,"Win"
"688","1996_1345_1441",1996,136,"1996_1345",1345,"1996_1441",1441,1,3,2,16,20,4,15,"Win"
"689","1996_1246_1448",1996,145,"1996_1246",1246,"1996_1448",1448,1,1,0,2,1,-1,1,"Win"
"690","1996_1400_1448",1996,139,"1996_1400",1400,"1996_1448",1448,10,11,1,2,1,-1,-8,"Lose"
"691","1996_1419_1448",1996,137,"1996_1419",1419,"1996_1448",1448,15,20,5,2,1,-1,-13,"Lose"
"692","1996_1257_1448",1996,143,"1996_1257",1257,"1996_1448",1448,6,11,5,2,1,-1,-4,"Lose"
"693","1996_1439_1453",1996,136,"1996_1439",1439,"1996_1453",1453,9,20,11,8,14,6,-1,"Win"
"694","1997_1139_1153",1997,136,"1997_1139",1139,"1997_1153",1153,14,20,6,3,2,-1,-11,"Lose"
"695","1997_1112_1158",1997,138,"1997_1112",1112,"1997_1158",1158,4,3,-1,12,20,8,8,"Win"
"696","1997_1150_1207",1997,137,"1997_1150",1150,"1997_1207",1207,7,20,13,10,2,-8,3,"Win"
"697","1997_1151_1208",1997,137,"1997_1151",1151,"1997_1208",1208,14,20,6,3,8,5,-11,"Win"
"698","1997_1151_1228",1997,139,"1997_1151",1151,"1997_1228",1228,14,20,6,6,20,14,-8,"Win"
"699","1997_1160_1231",1997,136,"1997_1160",1160,"1997_1231",1231,9,20,11,8,6,-2,-1,"Win"
"700","1997_1153_1235",1997,138,"1997_1153",1153,"1997_1235",1235,3,2,-1,6,5,-1,3,"Lose"
"701","1997_1229_1235",1997,136,"1997_1229",1229,"1997_1235",1235,11,20,9,6,5,-1,-5,"Lose"
"702","1997_1112_1242",1997,144,"1997_1112",1112,"1997_1242",1242,4,3,-1,1,2,1,-3,"Win"
"703","1997_1238_1242",1997,136,"1997_1238",1238,"1997_1242",1242,16,20,4,1,2,1,-15,"Lose"
"704","1997_1234_1246",1997,138,"1997_1234",1234,"1997_1246",1246,8,6,-2,1,1,0,-7,"Lose"
"705","1997_1112_1246",1997,154,"1997_1112",1112,"1997_1246",1246,4,3,-1,1,1,0,-3,"Win"
"706","1997_1158_1268",1997,136,"1997_1158",1158,"1997_1268",1268,12,20,8,5,7,2,-7,"Win"
"707","1997_1257_1269",1997,137,"1997_1257",1257,"1997_1269",1269,6,6,0,11,1,-10,5,"Win"
"708","1997_1155_1275",1997,137,"1997_1155",1155,"1997_1275",1275,4,9,5,13,20,7,9,"Win"
"709","1997_1246_1278",1997,152,"1997_1246",1246,"1997_1278",1278,1,1,0,1,20,19,0,"Win"
"710","1997_1155_1278",1997,143,"1997_1155",1155,"1997_1278",1278,4,9,5,1,20,19,-3,"Lose"
"711","1997_1246_1285",1997,136,"1997_1246",1246,"1997_1285",1285,1,1,0,16,20,4,15,"Win"
"712","1997_1181_1293",1997,137,"1997_1181",1181,"1997_1293",1293,2,8,6,15,20,5,13,"Win"
"713","1997_1257_1307",1997,139,"1997_1257",1257,"1997_1307",1307,6,6,0,3,7,4,-3,"Win"
"714","1997_1257_1314",1997,146,"1997_1257",1257,"1997_1314",1314,6,6,0,1,6,5,-5,"Lose"
"715","1997_1193_1314",1997,136,"1997_1193",1193,"1997_1314",1314,16,20,4,1,6,5,-15,"Lose"
"716","1997_1143_1314",1997,144,"1997_1143",1143,"1997_1314",1314,5,12,7,1,6,5,-4,"Lose"
"717","1997_1112_1314",1997,152,"1997_1112",1112,"1997_1314",1314,4,3,-1,1,6,5,-3,"Win"
"718","1997_1160_1314",1997,138,"1997_1160",1160,"1997_1314",1314,9,20,11,1,6,5,-8,"Lose"
"719","1997_1307_1330",1997,137,"1997_1307",1307,"1997_1330",1330,3,7,4,14,20,6,11,"Win"
"720","1997_1143_1343",1997,136,"1997_1143",1143,"1997_1343",1343,5,12,7,12,13,1,7,"Win"
"721","1997_1112_1344",1997,146,"1997_1112",1112,"1997_1344",1344,4,3,-1,10,20,10,6,"Win"
"722","1997_1181_1344",1997,139,"1997_1181",1181,"1997_1344",1344,2,8,6,10,20,10,8,"Lose"
"723","1997_1266_1344",1997,137,"1997_1266",1266,"1997_1344",1344,7,4,-3,10,20,10,3,"Lose"
"724","1997_1151_1344",1997,144,"1997_1151",1151,"1997_1344",1344,14,20,6,10,20,10,-4,"Lose"
"725","1997_1242_1345",1997,138,"1997_1242",1242,"1997_1345",1345,1,2,1,8,1,-7,7,"Win"
"726","1997_1345_1348",1997,136,"1997_1345",1345,"1997_1348",1348,8,1,-7,9,20,11,1,"Win"
"727","1997_1112_1375",1997,136,"1997_1112",1112,"1997_1375",1375,4,3,-1,13,20,7,9,"Win"
"728","1997_1164_1376",1997,137,"1997_1164",1164,"1997_1376",1376,15,20,5,2,20,18,-13,"Win"
"729","1997_1130_1386",1997,138,"1997_1130",1130,"1997_1386",1386,5,11,6,4,20,16,-1,"Lose"
"730","1997_1334_1386",1997,136,"1997_1334",1334,"1997_1386",1386,13,20,7,4,20,16,-9,"Lose"
"731","1997_1246_1386",1997,143,"1997_1246",1246,"1997_1386",1386,1,1,0,4,20,16,3,"Win"
"732","1997_1328_1390",1997,137,"1997_1328",1328,"1997_1390",1390,11,10,-1,6,9,3,-5,"Lose"
"733","1997_1278_1396",1997,139,"1997_1278",1278,"1997_1396",1396,1,20,19,9,7,-2,8,"Win"
"734","1997_1279_1396",1997,137,"1997_1279",1279,"1997_1396",1396,8,20,12,9,7,-2,1,"Lose"
"735","1997_1164_1400",1997,139,"1997_1164",1164,"1997_1400",1400,15,20,5,10,10,0,-5,"Lose"
"736","1997_1257_1400",1997,144,"1997_1257",1257,"1997_1400",1400,6,6,0,10,10,0,4,"Win"
"737","1997_1278_1402",1997,137,"1997_1278",1278,"1997_1402",1402,1,20,19,16,20,4,15,"Win"
"738","1997_1155_1409",1997,139,"1997_1155",1155,"1997_1409",1409,4,9,5,5,11,6,1,"Win"
"739","1997_1131_1409",1997,137,"1997_1131",1131,"1997_1409",1409,12,20,8,5,11,6,-7,"Lose"
"740","1997_1235_1417",1997,143,"1997_1235",1235,"1997_1417",1417,6,5,-1,2,4,2,-4,"Lose"
"741","1997_1149_1417",1997,136,"1997_1149",1149,"1997_1417",1417,15,20,5,2,4,2,-13,"Lose"
"742","1997_1278_1417",1997,145,"1997_1278",1278,"1997_1417",1417,1,20,19,2,4,2,1,"Win"
"743","1997_1228_1425",1997,137,"1997_1228",1228,"1997_1425",1425,6,20,14,11,20,9,5,"Win"
"744","1997_1390_1428",1997,143,"1997_1390",1390,"1997_1428",1428,6,9,3,2,4,2,-4,"Lose"
"745","1997_1298_1428",1997,137,"1997_1298",1298,"1997_1428",1428,15,20,5,2,4,2,-13,"Lose"
"746","1997_1150_1428",1997,139,"1997_1150",1150,"1997_1428",1428,7,20,13,2,4,2,-5,"Lose"
"747","1997_1246_1428",1997,145,"1997_1246",1246,"1997_1428",1428,1,1,0,2,4,2,1,"Win"
"748","1997_1130_1434",1997,136,"1997_1130",1130,"1997_1434",1434,5,11,6,12,14,2,7,"Win"
"749","1997_1254_1437",1997,136,"1997_1254",1254,"1997_1437",1437,13,20,7,4,3,-1,-9,"Lose"
"750","1997_1143_1437",1997,138,"1997_1143",1143,"1997_1437",1437,5,12,7,4,3,-1,-1,"Win"
"751","1997_1234_1438",1997,136,"1997_1234",1234,"1997_1438",1438,8,6,-2,9,20,11,1,"Win"
"752","1997_1388_1448",1997,137,"1997_1388",1388,"1997_1448",1448,14,20,6,3,2,-1,-11,"Lose"
"753","1997_1390_1448",1997,139,"1997_1390",1390,"1997_1448",1448,6,9,3,3,2,-1,-3,"Win"
"754","1997_1400_1458",1997,137,"1997_1400",1400,"1997_1458",1458,10,10,0,7,20,13,-3,"Win"
"755","1997_1417_1462",1997,138,"1997_1417",1417,"1997_1462",1462,2,4,2,7,20,13,5,"Win"
"756","1997_1435_1462",1997,136,"1997_1435",1435,"1997_1462",1462,10,20,10,7,20,13,-3,"Lose"
"757","1998_1163_1192",1998,136,"1998_1163",1163,"1998_1192",1192,2,20,18,15,20,5,13,"Win"
"758","1998_1150_1227",1998,136,"1998_1150",1150,"1998_1227",1227,8,7,-1,9,20,11,1,"Win"
"759","1998_1112_1229",1998,138,"1998_1112",1112,"1998_1229",1229,1,4,3,9,11,2,8,"Win"
"760","1998_1163_1231",1998,138,"1998_1163",1163,"1998_1231",1231,2,20,18,7,8,1,5,"Win"
"761","1998_1181_1246",1998,146,"1998_1181",1181,"1998_1246",1246,1,2,1,2,1,-1,1,"Lose"
"762","1998_1228_1268",1998,138,"1998_1228",1228,"1998_1268",1268,5,6,1,4,5,1,-1,"Lose"
"763","1998_1112_1268",1998,143,"1998_1112",1112,"1998_1268",1268,1,4,3,4,5,1,3,"Win"
"764","1998_1172_1276",1998,137,"1998_1172",1172,"1998_1276",1276,14,20,6,3,20,17,-11,"Lose"
"765","1998_1185_1277",1998,136,"1998_1185",1185,"1998_1277",1277,13,20,7,4,20,16,-9,"Lose"
"766","1998_1116_1304",1998,136,"1998_1116",1116,"1998_1304",1304,6,20,14,11,20,9,5,"Win"
"767","1998_1139_1307",1998,137,"1998_1139",1139,"1998_1307",1307,13,14,1,4,3,-1,-9,"Lose"
"768","1998_1112_1311",1998,136,"1998_1112",1112,"1998_1311",1311,1,4,3,16,20,4,15,"Win"
"769","1998_1150_1314",1998,138,"1998_1150",1150,"1998_1314",1314,8,7,-1,1,1,0,-7,"Lose"
"770","1998_1163_1314",1998,145,"1998_1163",1163,"1998_1314",1314,2,20,18,1,1,0,-1,"Lose"
"771","1998_1298_1314",1998,136,"1998_1298",1298,"1998_1314",1314,16,15,-1,1,1,0,-15,"Lose"
"772","1998_1277_1314",1998,143,"1998_1277",1277,"1998_1314",1314,4,20,16,1,1,0,-3,"Lose"
"773","1998_1153_1319",1998,136,"1998_1153",1153,"1998_1319",1319,2,3,1,15,20,5,13,"Win"
"774","1998_1231_1328",1998,136,"1998_1231",1231,"1998_1328",1328,7,8,1,10,11,1,3,"Win"
"775","1998_1181_1329",1998,139,"1998_1181",1181,"1998_1329",1329,1,2,1,8,20,12,7,"Win"
"776","1998_1203_1329",1998,137,"1998_1203",1203,"1998_1329",1329,9,20,11,8,20,12,-1,"Lose"
"777","1998_1242_1341",1998,137,"1998_1242",1242,"1998_1341",1341,1,1,0,16,20,4,15,"Win"
"778","1998_1277_1343",1998,138,"1998_1277",1277,"1998_1343",1343,4,20,16,5,12,7,1,"Win"
"779","1998_1174_1345",1998,137,"1998_1174",1174,"1998_1345",1345,15,20,5,2,8,6,-13,"Lose"
"780","1998_1178_1345",1998,139,"1998_1178",1178,"1998_1345",1345,10,20,10,2,8,6,-8,"Lose"
"781","1998_1181_1347",1998,137,"1998_1181",1181,"1998_1347",1347,1,2,1,16,20,4,15,"Win"
"782","1998_1242_1348",1998,139,"1998_1242",1242,"1998_1348",1348,1,1,0,8,9,1,7,"Lose"
"783","1998_1293_1348",1998,137,"1998_1293",1293,"1998_1348",1348,9,15,6,8,9,1,-1,"Lose"
"784","1998_1246_1354",1998,137,"1998_1246",1246,"1998_1354",1354,2,1,-1,15,20,5,13,"Win"
"785","1998_1228_1375",1998,136,"1998_1228",1228,"1998_1375",1375,5,6,1,12,13,1,7,"Win"
"786","1998_1350_1376",1998,136,"1998_1350",1350,"1998_1376",1376,14,20,6,3,2,-1,-11,"Win"
"787","1998_1178_1385",1998,137,"1998_1178",1178,"1998_1385",1385,10,20,10,7,20,13,-3,"Win"
"788","1998_1269_1387",1998,137,"1998_1269",1269,"1998_1387",1387,7,11,4,10,20,10,3,"Lose"
"789","1998_1246_1387",1998,139,"1998_1246",1246,"1998_1387",1387,2,1,-1,10,20,10,8,"Win"
"790","1998_1348_1390",1998,146,"1998_1348",1348,"1998_1390",1390,8,9,1,3,6,3,-5,"Lose"
"791","1998_1345_1390",1998,144,"1998_1345",1345,"1998_1390",1390,2,8,6,3,6,3,1,"Lose"
"792","1998_1158_1390",1998,137,"1998_1158",1158,"1998_1390",1390,14,12,-2,3,6,3,-11,"Lose"
"793","1998_1246_1390",1998,152,"1998_1246",1246,"1998_1390",1390,2,1,-1,3,6,3,1,"Win"
"794","1998_1233_1393",1998,137,"1998_1233",1233,"1998_1393",1393,12,20,8,5,20,15,-7,"Lose"
"795","1998_1181_1393",1998,144,"1998_1181",1181,"1998_1393",1393,1,2,1,5,20,15,4,"Win"
"796","1998_1307_1393",1998,139,"1998_1307",1307,"1998_1393",1393,4,3,-1,5,20,15,1,"Lose"
"797","1998_1199_1395",1998,137,"1998_1199",1199,"1998_1395",1395,12,20,8,5,20,15,-7,"Win"
"798","1998_1229_1397",1998,136,"1998_1229",1229,"1998_1397",1397,9,11,2,8,20,12,-1,"Win"
"799","1998_1276_1417",1998,139,"1998_1276",1276,"1998_1417",1417,3,20,17,6,2,-4,3,"Lose"
"800","1998_1246_1417",1998,144,"1998_1246",1246,"1998_1417",1417,2,1,-1,6,2,-4,4,"Win"
"801","1998_1274_1417",1998,137,"1998_1274",1274,"1998_1417",1417,11,20,9,6,2,-4,-5,"Lose"
"802","1998_1343_1424",1998,136,"1998_1343",1343,"1998_1424",1424,5,12,7,12,20,8,7,"Win"
"803","1998_1112_1428",1998,145,"1998_1112",1112,"1998_1428",1428,1,4,3,3,2,-1,2,"Lose"
"804","1998_1314_1428",1998,152,"1998_1314",1314,"1998_1428",1428,1,1,0,3,2,-1,2,"Lose"
"805","1998_1116_1428",1998,138,"1998_1116",1116,"1998_1428",1428,6,20,14,3,2,-1,-3,"Lose"
"806","1998_1362_1428",1998,136,"1998_1362",1362,"1998_1428",1428,14,20,6,3,2,-1,-11,"Lose"
"807","1998_1246_1428",1998,154,"1998_1246",1246,"1998_1428",1428,2,1,-1,3,2,-1,1,"Win"
"808","1998_1268_1429",1998,136,"1998_1268",1268,"1998_1429",1429,4,5,1,13,20,7,9,"Win"
"809","1998_1279_1434",1998,137,"1998_1279",1279,"1998_1434",1434,4,8,4,13,12,-1,9,"Lose"
"810","1998_1348_1434",1998,144,"1998_1348",1348,"1998_1434",1434,8,9,1,13,12,-1,5,"Win"
"811","1998_1199_1434",1998,139,"1998_1199",1199,"1998_1434",1434,12,20,8,13,12,-1,1,"Lose"
"812","1998_1155_1444",1998,137,"1998_1155",1155,"1998_1444",1444,6,4,-2,11,20,9,5,"Lose"
"813","1998_1390_1444",1998,139,"1998_1390",1390,"1998_1444",1444,3,6,3,11,20,9,8,"Win"
"814","1998_1350_1449",1998,138,"1998_1350",1350,"1998_1449",1449,14,20,6,11,20,9,-3,"Lose"
"815","1998_1163_1449",1998,143,"1998_1163",1163,"1998_1449",1449,2,20,18,11,20,9,9,"Win"
"816","1998_1396_1452",1998,136,"1998_1396",1396,"1998_1452",1452,7,9,2,10,20,10,3,"Lose"
"817","1998_1153_1452",1998,138,"1998_1153",1153,"1998_1452",1452,2,3,1,10,20,10,8,"Lose"
"818","1998_1428_1452",1998,143,"1998_1428",1428,"1998_1452",1452,3,2,-1,10,20,10,7,"Win"
"819","1998_1449_1462",1998,136,"1998_1449",1449,"1998_1462",1462,11,20,9,6,7,1,-5,"Win"
"820","1999_1163_1181",1999,154,"1999_1163",1163,"1999_1181",1181,1,2,1,1,1,0,0,"Win"
"821","1999_1181_1197",1999,137,"1999_1181",1181,"1999_1197",1197,1,1,0,16,20,4,15,"Win"
"822","1999_1153_1206",1999,137,"1999_1153",1153,"1999_1206",1206,3,2,-1,14,20,6,11,"Win"
"823","1999_1163_1211",1999,145,"1999_1163",1163,"1999_1211",1211,1,2,1,10,20,10,9,"Win"
"824","1999_1196_1211",1999,143,"1999_1196",1196,"1999_1211",1211,6,20,14,10,20,10,4,"Lose"
"825","1999_1203_1231",1999,136,"1999_1203",1203,"1999_1231",1231,11,9,-2,6,7,1,-5,"Lose"
"826","1999_1116_1234",1999,138,"1999_1116",1116,"1999_1234",1234,4,6,2,5,20,15,1,"Lose"
"827","1999_1163_1234",1999,143,"1999_1163",1163,"1999_1234",1234,1,2,1,5,20,15,4,"Win"
"828","1999_1191_1242",1999,137,"1999_1191",1191,"1999_1242",1242,11,20,9,6,1,-5,-5,"Lose"
"829","1999_1242_1246",1999,139,"1999_1242",1242,"1999_1246",1246,6,1,-5,3,2,-1,-3,"Lose"
"830","1999_1166_1257",1999,136,"1999_1166",1166,"1999_1257",1257,10,20,10,7,20,13,-3,"Win"
"831","1999_1166_1268",1999,138,"1999_1166",1166,"1999_1268",1268,10,20,10,2,4,2,-8,"Lose"
"832","1999_1248_1274",1999,137,"1999_1248",1248,"1999_1274",1274,15,20,5,2,11,9,-13,"Lose"
"833","1999_1246_1275",1999,144,"1999_1246",1246,"1999_1275",1275,3,2,-1,10,20,10,7,"Win"
"834","1999_1246_1277",1999,146,"1999_1246",1246,"1999_1277",1277,3,2,-1,1,4,3,-2,"Lose"
"835","1999_1181_1277",1999,152,"1999_1181",1181,"1999_1277",1277,1,1,0,1,4,3,0,"Win"
"836","1999_1211_1278",1999,136,"1999_1211",1211,"1999_1278",1278,10,20,10,7,20,13,-3,"Win"
"837","1999_1277_1279",1999,139,"1999_1277",1277,"1999_1279",1279,1,4,3,9,4,-5,8,"Win"
"838","1999_1181_1283",1999,144,"1999_1181",1181,"1999_1283",1283,1,1,0,12,20,8,11,"Win"
"839","1999_1277_1291",1999,137,"1999_1277",1277,"1999_1291",1291,1,4,3,16,20,4,15,"Win"
"840","1999_1281_1307",1999,136,"1999_1281",1281,"1999_1307",1307,8,20,12,9,4,-5,1,"Lose"
"841","1999_1163_1307",1999,138,"1999_1163",1163,"1999_1307",1307,1,2,1,9,4,-5,8,"Win"
"842","1999_1246_1308",1999,137,"1999_1246",1246,"1999_1308",1308,3,2,-1,14,20,6,11,"Win"
"843","1999_1293_1326",1999,136,"1999_1293",1293,"1999_1326",1326,13,9,-4,4,20,16,-9,"Lose"
"844","1999_1178_1326",1999,138,"1999_1178",1178,"1999_1326",1326,12,10,-2,4,20,16,-8,"Lose"
"845","1999_1120_1326",1999,143,"1999_1120",1120,"1999_1326",1326,1,20,19,4,20,16,3,"Lose"
"846","1999_1163_1326",1999,152,"1999_1163",1163,"1999_1326",1326,1,2,1,4,20,16,3,"Win"
"847","1999_1277_1328",1999,144,"1999_1277",1277,"1999_1328",1328,1,4,3,13,10,-3,12,"Win"
"848","1999_1112_1328",1999,137,"1999_1112",1112,"1999_1328",1328,4,1,-3,13,10,-3,9,"Lose"
"849","1999_1150_1328",1999,139,"1999_1150",1150,"1999_1328",1328,5,8,3,13,10,-3,8,"Lose"
"850","1999_1120_1329",1999,138,"1999_1120",1120,"1999_1329",1329,1,20,19,9,8,-1,8,"Win"
"851","1999_1196_1335",1999,136,"1999_1196",1196,"1999_1335",1335,6,20,14,11,20,9,5,"Win"
"852","1999_1274_1345",1999,139,"1999_1274",1274,"1999_1345",1345,2,11,9,10,2,-8,8,"Lose"
"853","1999_1150_1348",1999,137,"1999_1150",1150,"1999_1348",1348,5,8,3,12,8,-4,7,"Win"
"854","1999_1116_1373",1999,136,"1999_1116",1116,"1999_1373",1373,4,6,2,13,20,7,9,"Win"
"855","1999_1326_1385",1999,145,"1999_1326",1326,"1999_1385",1385,4,20,16,3,7,4,-1,"Win"
"856","1999_1231_1385",1999,138,"1999_1231",1231,"1999_1385",1385,6,7,1,3,7,4,-3,"Lose"
"857","1999_1359_1385",1999,136,"1999_1359",1359,"1999_1385",1385,14,20,6,3,7,4,-11,"Lose"
"858","1999_1268_1385",1999,143,"1999_1268",1268,"1999_1385",1385,2,4,2,3,7,4,1,"Lose"
"859","1999_1108_1390",1999,136,"1999_1108",1108,"1999_1390",1390,15,20,5,2,3,1,-13,"Lose"
"860","1999_1211_1390",1999,138,"1999_1211",1211,"1999_1390",1390,10,20,10,2,3,1,-8,"Win"
"861","1999_1329_1393",1999,136,"1999_1329",1329,"1999_1393",1393,9,8,-1,8,5,-3,-1,"Win"
"862","1999_1153_1396",1999,139,"1999_1153",1153,"1999_1396",1396,3,2,-1,6,7,1,3,"Lose"
"863","1999_1181_1396",1999,146,"1999_1181",1181,"1999_1396",1396,1,1,0,6,7,1,5,"Win"
"864","1999_1245_1396",1999,137,"1999_1245",1245,"1999_1396",1396,11,20,9,6,7,1,-5,"Lose"
"865","1999_1345_1396",1999,144,"1999_1345",1345,"1999_1396",1396,10,2,-8,6,7,1,-4,"Lose"
"866","1999_1174_1397",1999,137,"1999_1174",1174,"1999_1397",1397,13,15,2,4,8,4,-9,"Lose"
"867","1999_1283_1397",1999,139,"1999_1283",1283,"1999_1397",1397,12,20,8,4,8,4,-8,"Win"
"868","1999_1345_1400",1999,137,"1999_1345",1345,"1999_1400",1400,10,2,-8,7,20,13,-3,"Win"
"869","1999_1158_1409",1999,137,"1999_1158",1158,"1999_1409",1409,8,14,6,9,20,11,1,"Lose"
"870","1999_1181_1409",1999,139,"1999_1181",1181,"1999_1409",1409,1,1,0,9,20,11,8,"Win"
"871","1999_1234_1412",1999,136,"1999_1234",1234,"1999_1412",1412,5,20,15,12,20,8,7,"Win"
"872","1999_1178_1417",1999,136,"1999_1178",1178,"1999_1417",1417,12,10,-2,5,6,1,-7,"Win"
"873","1999_1163_1427",1999,136,"1999_1163",1163,"1999_1427",1427,1,2,1,16,20,4,15,"Win"
"874","1999_1117_1428",1999,137,"1999_1117",1117,"1999_1428",1428,15,20,5,2,3,1,-13,"Lose"
"875","1999_1275_1428",1999,139,"1999_1275",1275,"1999_1428",1428,10,20,10,2,3,1,-8,"Win"
"876","1999_1268_1434",1999,136,"1999_1268",1268,"1999_1434",1434,2,4,2,15,13,-2,13,"Win"
"877","1999_1279_1437",1999,137,"1999_1279",1279,"1999_1437",1437,9,4,-5,8,20,12,-1,"Win"
"878","1999_1275_1449",1999,137,"1999_1275",1275,"1999_1449",1449,10,20,10,7,11,4,-3,"Win"
"879","1999_1196_1451",1999,138,"1999_1196",1196,"1999_1451",1451,6,20,14,14,20,6,8,"Win"
"880","1999_1314_1451",1999,136,"1999_1314",1314,"1999_1451",1451,3,1,-2,14,20,6,11,"Lose"
"881","1999_1120_1457",1999,136,"1999_1120",1120,"1999_1457",1457,1,20,19,16,20,4,15,"Win"
"882","1999_1283_1458",1999,137,"1999_1283",1283,"1999_1458",1458,12,20,8,5,20,15,-7,"Win"
"883","2000_1120_1166",2000,136,"2000_1120",1120,"2000_1166",1166,7,1,-6,10,10,0,3,"Win"
"884","2000_1139_1196",2000,137,"2000_1139",1139,"2000_1196",1196,12,20,8,5,6,1,-7,"Lose"
"885","2000_1181_1196",2000,144,"2000_1181",1181,"2000_1196",1196,1,1,0,5,6,1,4,"Lose"
"886","2000_1196_1228",2000,139,"2000_1196",1196,"2000_1228",1228,5,6,1,4,20,16,-1,"Win"
"887","2000_1120_1235",2000,138,"2000_1120",1120,"2000_1235",1235,7,1,-6,2,20,18,-5,"Lose"
"888","2000_1148_1235",2000,136,"2000_1148",1148,"2000_1235",1235,15,20,5,2,20,18,-13,"Lose"
"889","2000_1112_1238",2000,136,"2000_1112",1112,"2000_1238",1238,1,4,3,16,20,4,15,"Win"
"890","2000_1177_1242",2000,137,"2000_1177",1177,"2000_1242",1242,9,20,11,8,6,-2,-1,"Lose"
"891","2000_1181_1242",2000,139,"2000_1181",1181,"2000_1242",1242,1,1,0,8,6,-2,7,"Win"
"892","2000_1181_1249",2000,137,"2000_1181",1181,"2000_1249",1249,1,1,0,16,20,4,15,"Win"
"893","2000_1211_1257",2000,136,"2000_1211",1211,"2000_1257",1257,10,10,0,7,7,0,-3,"Win"
"894","2000_1233_1268",2000,136,"2000_1233",1233,"2000_1268",1268,14,20,6,3,2,-1,-11,"Lose"
"895","2000_1116_1274",2000,137,"2000_1116",1116,"2000_1274",1274,11,4,-7,6,2,-4,-5,"Lose"
"896","2000_1235_1277",2000,145,"2000_1235",1235,"2000_1277",1277,2,20,18,1,1,0,-1,"Lose"
"897","2000_1196_1277",2000,154,"2000_1196",1196,"2000_1277",1277,5,6,1,1,1,0,-4,"Lose"
"898","2000_1281_1314",2000,137,"2000_1281",1281,"2000_1314",1314,9,8,-1,8,3,-5,-1,"Lose"
"899","2000_1196_1314",2000,152,"2000_1196",1196,"2000_1314",1314,5,6,1,8,3,-5,3,"Win"
"900","2000_1111_1326",2000,137,"2000_1111",1111,"2000_1326",1326,14,20,6,3,4,1,-11,"Lose"
"901","2000_1274_1326",2000,139,"2000_1274",1274,"2000_1326",1326,6,2,-4,3,4,1,-3,"Win"
"902","2000_1196_1329",2000,146,"2000_1196",1196,"2000_1329",1329,5,6,1,3,9,6,-2,"Win"
"903","2000_1220_1329",2000,137,"2000_1220",1220,"2000_1329",1329,14,20,6,3,9,6,-11,"Lose"
"904","2000_1228_1335",2000,137,"2000_1228",1228,"2000_1335",1335,4,20,16,13,11,-2,9,"Win"
"905","2000_1231_1337",2000,137,"2000_1231",1231,"2000_1337",1337,6,6,0,11,20,9,5,"Lose"
"906","2000_1329_1337",2000,139,"2000_1329",1329,"2000_1337",1337,3,9,6,11,20,9,8,"Win"
"907","2000_1173_1345",2000,136,"2000_1173",1173,"2000_1345",1345,11,20,9,6,10,4,-5,"Lose"
"908","2000_1328_1345",2000,138,"2000_1328",1328,"2000_1345",1345,3,13,10,6,10,4,3,"Lose"
"909","2000_1211_1345",2000,143,"2000_1211",1211,"2000_1345",1345,10,10,0,6,10,4,-4,"Lose"
"910","2000_1261_1369",2000,136,"2000_1261",1261,"2000_1369",1369,4,20,16,13,20,7,9,"Win"
"911","2000_1329_1371",2000,144,"2000_1329",1329,"2000_1371",1371,3,9,6,10,20,10,7,"Win"
"912","2000_1332_1371",2000,137,"2000_1332",1332,"2000_1371",1371,7,20,13,10,20,10,3,"Lose"
"913","2000_1246_1382",2000,136,"2000_1246",1246,"2000_1382",1382,5,3,-2,12,20,8,7,"Win"
"914","2000_1319_1385",2000,136,"2000_1319",1319,"2000_1385",1385,15,20,5,2,3,1,-13,"Lose"
"915","2000_1211_1385",2000,138,"2000_1211",1211,"2000_1385",1385,10,10,0,2,3,1,-8,"Win"
"916","2000_1354_1390",2000,137,"2000_1354",1354,"2000_1390",1390,16,20,4,1,2,1,-15,"Lose"
"917","2000_1314_1390",2000,139,"2000_1314",1314,"2000_1390",1390,8,3,-5,1,2,1,-7,"Win"
"918","2000_1246_1393",2000,138,"2000_1246",1246,"2000_1393",1393,5,3,-2,4,8,4,-1,"Lose"
"919","2000_1277_1393",2000,143,"2000_1277",1277,"2000_1393",1393,1,1,0,4,8,4,3,"Win"
"920","2000_1359_1393",2000,136,"2000_1359",1359,"2000_1393",1393,13,14,1,4,8,4,-9,"Lose"
"921","2000_1248_1396",2000,137,"2000_1248",1248,"2000_1396",1396,15,15,0,2,6,4,-13,"Lose"
"922","2000_1371_1396",2000,139,"2000_1371",1371,"2000_1396",1396,10,20,10,2,6,4,-8,"Win"
"923","2000_1314_1397",2000,144,"2000_1314",1314,"2000_1397",1397,8,3,-5,4,4,0,-4,"Win"
"924","2000_1163_1397",2000,139,"2000_1163",1163,"2000_1397",1397,5,1,-4,4,4,0,-1,"Lose"
"925","2000_1232_1400",2000,136,"2000_1232",1232,"2000_1400",1400,12,20,8,5,7,2,-7,"Lose"
"926","2000_1261_1400",2000,138,"2000_1261",1261,"2000_1400",1400,4,20,16,5,7,2,1,"Win"
"927","2000_1314_1409",2000,146,"2000_1314",1314,"2000_1409",1409,8,3,-5,7,9,2,-1,"Win"
"928","2000_1274_1409",2000,144,"2000_1274",1274,"2000_1409",1409,6,2,-4,7,9,2,1,"Lose"
"929","2000_1153_1409",2000,139,"2000_1153",1153,"2000_1409",1409,2,3,1,7,9,2,5,"Lose"
"930","2000_1235_1417",2000,143,"2000_1235",1235,"2000_1417",1417,2,20,18,6,5,-1,4,"Win"
"931","2000_1123_1417",2000,136,"2000_1123",1123,"2000_1417",1417,11,20,9,6,5,-1,-5,"Lose"
"932","2000_1268_1417",2000,138,"2000_1268",1268,"2000_1417",1417,3,2,-1,6,5,-1,3,"Lose"
"933","2000_1397_1418",2000,137,"2000_1397",1397,"2000_1418",1418,4,4,0,13,20,7,9,"Win"
"934","2000_1153_1423",2000,137,"2000_1153",1153,"2000_1423",1423,2,3,1,15,20,5,13,"Win"
"935","2000_1409_1424",2000,137,"2000_1409",1409,"2000_1424",1424,7,9,2,10,20,10,3,"Win"
"936","2000_1277_1428",2000,138,"2000_1277",1277,"2000_1428",1428,1,1,0,8,2,-6,7,"Win"
"937","2000_1387_1428",2000,136,"2000_1387",1387,"2000_1428",1428,9,20,11,8,2,-6,-1,"Lose"
"938","2000_1163_1429",2000,137,"2000_1163",1163,"2000_1429",1429,5,1,-4,12,20,8,7,"Win"
"939","2000_1277_1434",2000,136,"2000_1277",1277,"2000_1434",1434,1,1,0,16,15,-1,15,"Win"
"940","2000_1328_1457",2000,136,"2000_1328",1328,"2000_1457",1457,3,13,10,14,16,2,11,"Win"
"941","2000_1345_1458",2000,145,"2000_1345",1345,"2000_1458",1458,6,10,4,8,5,-3,2,"Lose"
"942","2000_1261_1458",2000,143,"2000_1261",1261,"2000_1458",1458,4,20,16,8,5,-3,4,"Lose"
"943","2000_1277_1458",2000,152,"2000_1277",1277,"2000_1458",1458,1,1,0,8,5,-3,7,"Win"
"944","2000_1112_1458",2000,138,"2000_1112",1112,"2000_1458",1458,1,4,3,8,5,-3,7,"Lose"
"945","2000_1201_1458",2000,136,"2000_1201",1201,"2000_1458",1458,9,20,11,8,5,-3,-1,"Lose"
"946","2001_1112_1139",2001,139,"2001_1112",1112,"2001_1139",1139,2,1,-1,10,12,2,8,"Win"
"947","2001_1140_1153",2001,136,"2001_1140",1140,"2001_1153",1153,12,20,8,5,2,-3,-7,"Lose"
"948","2001_1112_1181",2001,154,"2001_1112",1112,"2001_1181",1181,2,1,-1,1,1,0,-1,"Lose"
"949","2001_1112_1183",2001,137,"2001_1112",1112,"2001_1183",1183,2,1,-1,15,20,5,13,"Win"
"950","2001_1143_1201",2001,137,"2001_1143",1143,"2001_1201",1201,8,20,12,9,9,0,1,"Lose"
"951","2001_1116_1207",2001,136,"2001_1116",1116,"2001_1207",1207,7,11,4,10,20,10,3,"Lose"
"952","2001_1207_1214",2001,138,"2001_1207",1207,"2001_1214",1214,10,20,10,15,20,5,5,"Win"
"953","2001_1112_1228",2001,146,"2001_1112",1112,"2001_1228",1228,2,1,-1,1,4,3,-1,"Win"
"954","2001_1150_1228",2001,139,"2001_1150",1150,"2001_1228",1228,9,20,11,1,4,3,-8,"Lose"
"955","2001_1211_1232",2001,139,"2001_1211",1211,"2001_1232",1232,12,10,-2,13,12,-1,1,"Win"
"956","2001_1166_1234",2001,136,"2001_1166",1166,"2001_1234",1234,10,10,0,7,20,13,-3,"Lose"
"957","2001_1214_1235",2001,136,"2001_1214",1214,"2001_1235",1235,15,20,5,2,2,0,-13,"Win"
"958","2001_1228_1242",2001,144,"2001_1228",1228,"2001_1242",1242,1,4,3,4,8,4,3,"Win"
"959","2001_1169_1242",2001,137,"2001_1169",1169,"2001_1242",1242,13,20,7,4,8,4,-9,"Lose"
"960","2001_1153_1245",2001,138,"2001_1153",1153,"2001_1245",1245,5,2,-3,13,20,7,8,"Win"
"961","2001_1231_1245",2001,136,"2001_1231",1231,"2001_1245",1245,4,6,2,13,20,7,9,"Lose"
"962","2001_1221_1246",2001,136,"2001_1221",1221,"2001_1246",1246,15,20,5,2,5,3,-13,"Lose"
"963","2001_1234_1246",2001,138,"2001_1234",1234,"2001_1246",1246,7,20,13,2,5,3,-5,"Lose"
"964","2001_1181_1268",2001,152,"2001_1181",1181,"2001_1268",1268,1,1,0,3,3,0,2,"Win"
"965","2001_1207_1268",2001,143,"2001_1207",1207,"2001_1268",1268,10,20,10,3,3,0,-7,"Lose"
"966","2001_1209_1268",2001,138,"2001_1209",1209,"2001_1268",1268,11,20,9,3,3,0,-8,"Lose"
"967","2001_1206_1268",2001,136,"2001_1206",1206,"2001_1268",1268,14,20,6,3,3,0,-11,"Lose"
"968","2001_1106_1277",2001,137,"2001_1106",1106,"2001_1277",1277,16,20,4,1,1,0,-15,"Lose"
"969","2001_1201_1277",2001,139,"2001_1201",1201,"2001_1277",1277,9,9,0,1,1,0,-8,"Lose"
"970","2001_1211_1277",2001,144,"2001_1211",1211,"2001_1277",1277,12,10,-2,1,1,0,-11,"Lose"
"971","2001_1112_1277",2001,152,"2001_1112",1112,"2001_1277",1277,2,1,-1,1,1,0,-1,"Win"
"972","2001_1233_1279",2001,137,"2001_1233",1233,"2001_1279",1279,14,14,0,3,20,17,-11,"Lose"
"973","2001_1112_1279",2001,144,"2001_1112",1112,"2001_1279",1279,2,1,-1,3,20,17,1,"Win"
"974","2001_1181_1281",2001,138,"2001_1181",1181,"2001_1281",1281,1,1,0,9,9,0,8,"Win"
"975","2001_1208_1281",2001,136,"2001_1208",1208,"2001_1281",1281,8,20,12,9,9,0,1,"Lose"
"976","2001_1181_1284",2001,136,"2001_1181",1181,"2001_1284",1284,1,1,0,16,20,4,15,"Win"
"977","2001_1228_1322",2001,137,"2001_1228",1228,"2001_1322",1322,1,4,3,16,20,4,15,"Win"
"978","2001_1279_1323",2001,139,"2001_1279",1279,"2001_1323",1323,3,20,17,6,20,14,3,"Win"
"979","2001_1232_1328",2001,137,"2001_1232",1232,"2001_1328",1328,13,12,-1,4,3,-1,-9,"Win"
"980","2001_1314_1336",2001,139,"2001_1314",1314,"2001_1336",1336,2,8,6,7,20,13,5,"Lose"
"981","2001_1314_1343",2001,137,"2001_1314",1314,"2001_1343",1343,2,8,6,15,20,5,13,"Win"
"982","2001_1336_1344",2001,137,"2001_1336",1336,"2001_1344",1344,7,20,13,10,20,10,3,"Win"
"983","2001_1130_1381",2001,136,"2001_1130",1130,"2001_1381",1381,3,20,17,14,20,6,11,"Win"
"984","2001_1210_1386",2001,136,"2001_1210",1210,"2001_1386",1386,8,20,12,9,20,11,1,"Lose"
"985","2001_1268_1390",2001,145,"2001_1268",1268,"2001_1390",1390,3,3,0,1,1,0,-2,"Win"
"986","2001_1386_1390",2001,138,"2001_1386",1386,"2001_1390",1390,9,20,11,1,1,0,-8,"Lose"
"987","2001_1153_1390",2001,143,"2001_1153",1153,"2001_1390",1390,5,2,-3,1,1,0,-4,"Lose"
"988","2001_1242_1393",2001,139,"2001_1242",1242,"2001_1393",1393,4,8,4,5,4,-1,1,"Win"
"989","2001_1218_1393",2001,137,"2001_1218",1218,"2001_1393",1393,12,20,8,5,4,-1,-7,"Lose"
"990","2001_1196_1396",2001,139,"2001_1196",1196,"2001_1396",1396,3,5,2,11,2,-9,8,"Lose"
"991","2001_1277_1396",2001,146,"2001_1277",1277,"2001_1396",1396,1,1,0,11,2,-9,10,"Win"
"992","2001_1336_1396",2001,144,"2001_1336",1336,"2001_1396",1396,7,20,13,11,2,-9,4,"Lose"
"993","2001_1150_1397",2001,137,"2001_1150",1150,"2001_1397",1397,9,20,11,8,4,-4,-1,"Win"
"994","2001_1396_1400",2001,137,"2001_1396",1396,"2001_1400",1400,11,2,-9,6,5,-1,-5,"Win"
"995","2001_1220_1417",2001,136,"2001_1220",1220,"2001_1417",1417,13,14,1,4,6,2,-9,"Lose"
"996","2001_1181_1417",2001,143,"2001_1181",1181,"2001_1417",1417,1,1,0,4,6,2,3,"Win"
"997","2001_1390_1422",2001,136,"2001_1390",1390,"2001_1422",1422,1,1,0,16,20,4,15,"Win"
"998","2001_1181_1425",2001,145,"2001_1181",1181,"2001_1425",1425,1,1,0,6,20,14,5,"Win"
"999","2001_1130_1425",2001,138,"2001_1130",1130,"2001_1425",1425,3,20,17,6,20,14,3,"Lose"
"1000","2001_1329_1425",2001,136,"2001_1329",1329,"2001_1425",1425,11,3,-8,6,20,14,-5,"Lose"
"1001","2001_1246_1425",2001,143,"2001_1246",1246,"2001_1425",1425,2,5,3,6,20,14,4,"Lose"
"1002","2001_1417_1429",2001,138,"2001_1417",1417,"2001_1429",1429,4,6,2,12,12,0,8,"Win"
"1003","2001_1326_1429",2001,136,"2001_1326",1326,"2001_1429",1429,5,3,-2,12,12,0,7,"Lose"
"1004","2001_1211_1438",2001,137,"2001_1211",1211,"2001_1438",1438,12,10,-2,5,20,15,-7,"Win"
"1005","2001_1196_1443",2001,137,"2001_1196",1196,"2001_1443",1443,3,5,2,14,20,6,11,"Win"
"1006","2001_1139_1448",2001,137,"2001_1139",1139,"2001_1448",1448,10,12,2,7,20,13,-3,"Win"
"1007","2001_1322_1457",2001,134,"2001_1322",1322,"2001_1457",1457,16,20,4,16,14,-2,0,"Win"
"1008","2001_1209_1458",2001,136,"2001_1209",1209,"2001_1458",1458,11,20,9,6,8,2,-5,"Win"
"1009","2001_1323_1462",2001,137,"2001_1323",1323,"2001_1462",1462,6,20,14,11,20,9,5,"Win"
"1010","2002_1131_1153",2002,137,"2002_1131",1131,"2002_1153",1153,16,20,4,1,5,4,-15,"Lose"
"1011","2002_1104_1194",2002,136,"2002_1104",1104,"2002_1194",1194,2,20,18,15,20,5,13,"Win"
"1012","2002_1166_1196",2002,137,"2002_1166",1166,"2002_1196",1196,12,10,-2,5,3,-2,-7,"Win"
"1013","2002_1163_1214",2002,137,"2002_1163",1163,"2002_1214",1214,2,20,18,15,15,0,13,"Win"
"1014","2002_1166_1228",2002,139,"2002_1166",1166,"2002_1228",1228,12,10,-2,4,1,-3,-8,"Lose"
"1015","2002_1181_1231",2002,143,"2002_1181",1181,"2002_1231",1231,1,1,0,5,4,-1,4,"Lose"
"1016","2002_1228_1242",2002,144,"2002_1228",1228,"2002_1242",1242,4,1,-3,1,4,3,-3,"Lose"
"1017","2002_1221_1242",2002,136,"2002_1221",1221,"2002_1242",1242,16,15,-1,1,4,3,-15,"Lose"
"1018","2002_1104_1245",2002,138,"2002_1104",1104,"2002_1245",1245,2,20,18,10,13,3,8,"Lose"
"1019","2002_1231_1245",2002,145,"2002_1231",1231,"2002_1245",1245,5,4,-1,10,13,3,5,"Win"
"1020","2002_1246_1268",2002,144,"2002_1246",1246,"2002_1268",1268,4,2,-2,1,3,2,-3,"Lose"
"1021","2002_1231_1268",2002,154,"2002_1231",1231,"2002_1268",1268,5,4,-1,1,3,2,-4,"Lose"
"1022","2002_1242_1268",2002,152,"2002_1242",1242,"2002_1268",1268,1,4,3,1,3,2,0,"Lose"
"1023","2002_1163_1268",2002,146,"2002_1163",1163,"2002_1268",1268,2,20,18,1,3,2,-1,"Lose"
"1024","2002_1270_1280",2002,137,"2002_1270",1270,"2002_1280",1280,14,20,6,3,20,17,-11,"Lose"
"1025","2002_1274_1281",2002,136,"2002_1274",1274,"2002_1281",1281,5,20,15,12,9,-3,7,"Lose"
"1026","2002_1208_1293",2002,137,"2002_1208",1208,"2002_1293",1293,3,8,5,14,20,6,11,"Win"
"1027","2002_1163_1301",2002,139,"2002_1163",1163,"2002_1301",1301,2,20,18,7,20,13,5,"Win"
"1028","2002_1277_1301",2002,137,"2002_1277",1277,"2002_1301",1301,10,1,-9,7,20,13,-3,"Lose"
"1029","2002_1181_1323",2002,138,"2002_1181",1181,"2002_1323",1323,1,1,0,8,6,-2,7,"Win"
"1030","2002_1150_1323",2002,136,"2002_1150",1150,"2002_1323",1323,9,9,0,8,6,-2,-1,"Lose"
"1031","2002_1281_1326",2002,138,"2002_1281",1281,"2002_1326",1326,12,9,-3,4,5,1,-8,"Win"
"1032","2002_1172_1326",2002,136,"2002_1172",1172,"2002_1326",1326,13,20,7,4,5,1,-9,"Lose"
"1033","2002_1112_1328",2002,143,"2002_1112",1112,"2002_1328",1328,3,2,-1,2,4,2,-1,"Lose"
"1034","2002_1231_1328",2002,152,"2002_1231",1231,"2002_1328",1328,5,4,-1,2,4,2,-3,"Win"
"1035","2002_1281_1328",2002,145,"2002_1281",1281,"2002_1328",1328,12,9,-3,2,4,2,-10,"Lose"
"1036","2002_1227_1328",2002,137,"2002_1227",1227,"2002_1328",1328,15,20,5,2,4,2,-13,"Lose"
"1037","2002_1245_1329",2002,136,"2002_1245",1245,"2002_1329",1329,10,13,3,7,11,4,-3,"Win"
"1038","2002_1242_1332",2002,146,"2002_1242",1242,"2002_1332",1332,1,4,3,2,20,18,1,"Win"
"1039","2002_1285_1332",2002,136,"2002_1285",1285,"2002_1332",1332,15,20,5,2,20,18,-13,"Lose"
"1040","2002_1143_1335",2002,137,"2002_1143",1143,"2002_1335",1335,6,8,2,11,20,9,5,"Win"
"1041","2002_1148_1338",2002,137,"2002_1148",1148,"2002_1338",1338,14,20,6,3,20,17,-11,"Lose"
"1042","2002_1143_1338",2002,139,"2002_1143",1143,"2002_1338",1338,6,8,2,3,20,17,-3,"Lose"
"1043","2002_1245_1338",2002,143,"2002_1245",1245,"2002_1338",1338,10,13,3,3,20,17,-7,"Win"
"1044","2002_1163_1356",2002,144,"2002_1163",1163,"2002_1356",1356,2,20,18,11,20,9,9,"Win"
"1045","2002_1208_1356",2002,139,"2002_1208",1208,"2002_1356",1356,3,8,5,11,20,9,8,"Lose"
"1046","2002_1228_1361",2002,137,"2002_1228",1228,"2002_1361",1361,4,1,-3,13,20,7,9,"Win"
"1047","2002_1112_1364",2002,136,"2002_1112",1112,"2002_1364",1364,3,2,-1,14,20,6,11,"Win"
"1048","2002_1268_1373",2002,137,"2002_1268",1268,"2002_1373",1373,1,3,2,16,20,4,15,"Win"
"1049","2002_1108_1373",2002,134,"2002_1108",1108,"2002_1373",1373,16,20,4,16,20,4,0,"Lose"
"1050","2002_1242_1390",2002,138,"2002_1242",1242,"2002_1390",1390,1,4,3,8,1,-7,7,"Win"
"1051","2002_1332_1400",2002,144,"2002_1332",1332,"2002_1400",1400,2,20,18,6,6,0,4,"Win"
"1052","2002_1130_1400",2002,137,"2002_1130",1130,"2002_1400",1400,11,3,-8,6,6,0,-5,"Lose"
"1053","2002_1280_1400",2002,139,"2002_1280",1280,"2002_1400",1400,3,20,17,6,6,0,3,"Lose"
"1054","2002_1356_1403",2002,137,"2002_1356",1356,"2002_1403",1403,11,20,9,6,20,14,-5,"Win"
"1055","2002_1266_1409",2002,136,"2002_1266",1266,"2002_1409",1409,5,20,15,12,20,8,7,"Lose"
"1056","2002_1246_1409",2002,138,"2002_1246",1246,"2002_1409",1409,4,2,-2,12,20,8,8,"Win"
"1057","2002_1279_1417",2002,137,"2002_1279",1279,"2002_1417",1417,9,3,-6,8,4,-4,-1,"Lose"
"1058","2002_1281_1417",2002,143,"2002_1281",1281,"2002_1417",1417,12,9,-3,8,4,-4,-4,"Win"
"1059","2002_1153_1417",2002,139,"2002_1153",1153,"2002_1417",1417,1,5,4,8,4,-4,7,"Lose"
"1060","2002_1231_1423",2002,138,"2002_1231",1231,"2002_1423",1423,5,4,-1,13,20,7,8,"Win"
"1061","2002_1423_1425",2002,136,"2002_1423",1423,"2002_1425",1425,13,20,7,4,6,2,-9,"Win"
"1062","2002_1231_1428",2002,136,"2002_1231",1231,"2002_1428",1428,5,4,-1,12,20,8,7,"Win"
"1063","2002_1246_1434",2002,136,"2002_1246",1246,"2002_1434",1434,4,2,-2,13,20,7,9,"Win"
"1064","2002_1390_1443",2002,136,"2002_1390",1390,"2002_1443",1443,8,1,-7,9,14,5,1,"Win"
"1065","2002_1337_1448",2002,136,"2002_1337",1337,"2002_1448",1448,10,20,10,7,7,0,-3,"Lose"
"1066","2002_1332_1448",2002,138,"2002_1332",1332,"2002_1448",1448,2,20,18,7,7,0,5,"Win"
"1067","2002_1181_1457",2002,136,"2002_1181",1181,"2002_1457",1457,1,1,0,16,16,0,15,"Win"
"1068","2002_1385_1458",2002,137,"2002_1385",1385,"2002_1458",1458,9,20,11,8,6,-2,-1,"Lose"
"1069","2002_1268_1458",2002,139,"2002_1268",1268,"2002_1458",1458,1,3,2,8,6,-2,7,"Win"
"1070","2002_1211_1461",2002,136,"2002_1211",1211,"2002_1461",1461,6,12,6,11,20,9,5,"Lose"
"1071","2002_1112_1461",2002,138,"2002_1112",1112,"2002_1461",1461,3,2,-1,11,20,9,8,"Win"
"1072","2002_1328_1462",2002,139,"2002_1328",1328,"2002_1462",1462,2,4,2,7,11,4,5,"Win"
"1073","2002_1218_1462",2002,137,"2002_1218",1218,"2002_1462",1462,10,12,2,7,11,4,-3,"Lose"
"1074","2003_1140_1163",2003,136,"2003_1140",1140,"2003_1163",1163,12,20,8,5,2,-3,-7,"Lose"
"1075","2003_1141_1166",2003,136,"2003_1141",1141,"2003_1166",1166,11,20,9,6,12,6,-5,"Win"
"1076","2003_1141_1181",2003,138,"2003_1141",1141,"2003_1181",1181,11,20,9,3,1,-2,-8,"Lose"
"1077","2003_1161_1181",2003,136,"2003_1161",1161,"2003_1181",1181,14,20,6,3,1,-2,-11,"Lose"
"1078","2003_1112_1211",2003,138,"2003_1112",1112,"2003_1211",1211,1,3,2,9,6,-3,8,"Win"
"1079","2003_1153_1211",2003,136,"2003_1153",1153,"2003_1211",1211,8,1,-7,9,6,-3,1,"Lose"
"1080","2003_1104_1231",2003,137,"2003_1104",1104,"2003_1231",1231,10,2,-8,7,5,-2,-3,"Lose"
"1081","2003_1112_1242",2003,145,"2003_1112",1112,"2003_1242",1242,1,3,2,2,1,-1,1,"Lose"
"1082","2003_1181_1242",2003,143,"2003_1181",1181,"2003_1242",1242,3,1,-2,2,1,-1,-1,"Lose"
"1083","2003_1113_1242",2003,138,"2003_1113",1113,"2003_1242",1242,10,20,10,2,1,-1,-8,"Lose"
"1084","2003_1237_1246",2003,137,"2003_1237",1237,"2003_1246",1246,16,20,4,1,4,3,-15,"Lose"
"1085","2003_1122_1257",2003,137,"2003_1122",1122,"2003_1257",1257,13,20,7,4,20,16,-9,"Lose"
"1086","2003_1139_1257",2003,139,"2003_1139",1139,"2003_1257",1257,12,20,8,4,20,16,-8,"Win"
"1087","2003_1221_1266",2003,136,"2003_1221",1221,"2003_1266",1266,14,16,2,3,5,2,-11,"Lose"
"1088","2003_1242_1266",2003,152,"2003_1242",1242,"2003_1266",1266,2,1,-1,3,5,2,1,"Win"
"1089","2003_1246_1266",2003,145,"2003_1246",1246,"2003_1266",1266,1,4,3,3,5,2,2,"Lose"
"1090","2003_1113_1272",2003,136,"2003_1113",1113,"2003_1272",1272,10,20,10,7,20,13,-3,"Win"
"1091","2003_1160_1277",2003,137,"2003_1160",1160,"2003_1277",1277,10,20,10,7,10,3,-3,"Lose"
"1092","2003_1268_1277",2003,144,"2003_1268",1268,"2003_1277",1277,6,1,-5,7,10,3,1,"Lose"
"1093","2003_1196_1277",2003,139,"2003_1196",1196,"2003_1277",1277,2,5,3,7,10,3,5,"Lose"
"1094","2003_1139_1280",2003,137,"2003_1139",1139,"2003_1280",1280,12,20,8,5,3,-2,-7,"Win"
"1095","2003_1266_1281",2003,138,"2003_1266",1266,"2003_1281",1281,3,5,2,6,12,6,3,"Win"
"1096","2003_1143_1301",2003,136,"2003_1143",1143,"2003_1301",1301,8,6,-2,9,7,-2,1,"Win"
"1097","2003_1228_1323",2003,138,"2003_1228",1228,"2003_1323",1323,4,4,0,5,8,3,1,"Lose"
"1098","2003_1112_1323",2003,143,"2003_1112",1112,"2003_1323",1323,1,3,2,5,8,3,4,"Win"
"1099","2003_1139_1328",2003,144,"2003_1139",1139,"2003_1328",1328,12,20,8,1,2,1,-11,"Lose"
"1100","2003_1143_1328",2003,138,"2003_1143",1143,"2003_1328",1328,8,6,-2,1,2,1,-7,"Lose"
"1101","2003_1329_1335",2003,137,"2003_1329",1329,"2003_1335",1335,6,7,1,11,11,0,5,"Win"
"1102","2003_1231_1338",2003,139,"2003_1231",1231,"2003_1338",1338,7,5,-2,2,3,1,-5,"Lose"
"1103","2003_1266_1338",2003,143,"2003_1266",1266,"2003_1338",1338,3,5,2,2,3,1,-1,"Win"
"1104","2003_1261_1345",2003,137,"2003_1261",1261,"2003_1345",1345,8,20,12,9,20,11,1,"Lose"
"1105","2003_1328_1354",2003,136,"2003_1328",1328,"2003_1354",1354,1,2,1,16,20,4,15,"Win"
"1106","2003_1281_1356",2003,136,"2003_1281",1281,"2003_1356",1356,6,12,6,11,11,0,5,"Win"
"1107","2003_1196_1358",2003,137,"2003_1196",1196,"2003_1358",1358,2,5,3,15,20,5,13,"Win"
"1108","2003_1120_1386",2003,137,"2003_1120",1120,"2003_1386",1386,10,20,10,7,20,13,-3,"Win"
"1109","2003_1360_1390",2003,136,"2003_1360",1360,"2003_1390",1390,13,20,7,4,8,4,-9,"Lose"
"1110","2003_1163_1390",2003,138,"2003_1163",1163,"2003_1390",1390,5,2,-3,4,8,4,-1,"Win"
"1111","2003_1120_1393",2003,144,"2003_1120",1120,"2003_1393",1393,10,20,10,3,20,17,-7,"Lose"
"1112","2003_1328_1393",2003,146,"2003_1328",1328,"2003_1393",1393,1,2,1,3,20,17,2,"Lose"
"1113","2003_1242_1393",2003,154,"2003_1242",1242,"2003_1393",1393,2,1,-1,3,20,17,1,"Lose"
"1114","2003_1264_1393",2003,137,"2003_1264",1264,"2003_1393",1393,14,20,6,3,20,17,-11,"Lose"
"1115","2003_1329_1393",2003,139,"2003_1329",1329,"2003_1393",1393,6,7,1,3,20,17,-3,"Lose"
"1116","2003_1393_1400",2003,152,"2003_1393",1393,"2003_1400",1400,3,20,17,1,6,5,-2,"Win"
"1117","2003_1163_1400",2003,144,"2003_1163",1163,"2003_1400",1400,5,2,-3,1,6,5,-4,"Lose"
"1118","2003_1277_1400",2003,146,"2003_1277",1277,"2003_1400",1400,7,10,3,1,6,5,-6,"Lose"
"1119","2003_1345_1400",2003,139,"2003_1345",1345,"2003_1400",1400,9,20,11,1,6,5,-8,"Lose"
"1120","2003_1173_1409",2003,136,"2003_1173",1173,"2003_1409",1409,4,20,16,13,12,-1,9,"Lose"
"1121","2003_1411_1421",2003,134,"2003_1411",1411,"2003_1421",1421,16,20,4,16,20,4,0,"Lose"
"1122","2003_1400_1421",2003,137,"2003_1400",1400,"2003_1421",1421,1,6,5,16,20,4,15,"Win"
"1123","2003_1268_1423",2003,137,"2003_1268",1268,"2003_1423",1423,6,1,-5,11,13,2,5,"Win"
"1124","2003_1332_1428",2003,137,"2003_1332",1332,"2003_1428",1428,8,2,-6,9,12,3,1,"Lose"
"1125","2003_1246_1428",2003,139,"2003_1246",1246,"2003_1428",1428,1,4,3,9,12,3,8,"Win"
"1126","2003_1242_1429",2003,136,"2003_1242",1242,"2003_1429",1429,2,1,-1,15,20,5,13,"Win"
"1127","2003_1112_1436",2003,136,"2003_1112",1112,"2003_1436",1436,1,3,2,16,20,4,15,"Win"
"1128","2003_1228_1443",2003,136,"2003_1228",1228,"2003_1443",1443,4,4,0,13,9,-4,9,"Win"
"1129","2003_1338_1447",2003,137,"2003_1338",1338,"2003_1447",1447,2,3,1,15,20,5,13,"Win"
"1130","2003_1190_1448",2003,137,"2003_1190",1190,"2003_1448",1448,15,20,5,2,7,5,-13,"Lose"
"1131","2003_1120_1448",2003,139,"2003_1120",1120,"2003_1448",1448,10,20,10,2,7,5,-8,"Win"
"1132","2003_1323_1454",2003,136,"2003_1323",1323,"2003_1454",1454,5,8,3,12,20,8,7,"Win"
"1133","2003_1451_1458",2003,136,"2003_1451",1451,"2003_1458",1458,12,20,8,5,8,3,-7,"Lose"
"1134","2003_1409_1458",2003,138,"2003_1409",1409,"2003_1458",1458,13,12,-1,5,8,3,-8,"Lose"
"1135","2003_1246_1458",2003,143,"2003_1246",1246,"2003_1458",1458,1,4,3,5,8,3,4,"Win"
"1136","2003_1268_1462",2003,139,"2003_1268",1268,"2003_1462",1462,6,1,-5,3,7,4,-3,"Win"
"1137","2003_1407_1462",2003,137,"2003_1407",1407,"2003_1462",1462,14,20,6,3,7,4,-11,"Lose"
"1138","2004_1104_1163",2004,145,"2004_1104",1104,"2004_1163",1163,8,10,2,2,5,3,-6,"Lose"
"1139","2004_1163_1177",2004,138,"2004_1163",1163,"2004_1177",1177,2,5,3,7,20,13,5,"Win"
"1140","2004_1173_1177",2004,136,"2004_1173",1173,"2004_1177",1177,10,4,-6,7,20,13,-3,"Lose"
"1141","2004_1163_1181",2004,152,"2004_1163",1163,"2004_1181",1181,2,5,3,1,3,2,-1,"Win"
"1142","2004_1106_1181",2004,136,"2004_1106",1106,"2004_1181",1181,16,20,4,1,3,2,-15,"Lose"
"1143","2004_1153_1190",2004,137,"2004_1153",1153,"2004_1190",1190,4,8,4,13,15,2,9,"Win"
"1144","2004_1130_1210",2004,139,"2004_1130",1130,"2004_1210",1210,6,20,14,3,20,17,-3,"Lose"
"1145","2004_1163_1210",2004,154,"2004_1163",1163,"2004_1210",1210,2,5,3,3,20,17,1,"Win"
"1146","2004_1153_1228",2004,139,"2004_1153",1153,"2004_1228",1228,4,8,4,5,4,-1,1,"Lose"
"1147","2004_1181_1228",2004,144,"2004_1181",1181,"2004_1228",1228,1,3,2,5,4,-1,4,"Win"
"1148","2004_1210_1242",2004,146,"2004_1210",1210,"2004_1242",1242,3,20,17,4,2,-2,1,"Win"
"1149","2004_1227_1242",2004,137,"2004_1227",1227,"2004_1242",1242,13,20,7,4,2,-2,-9,"Lose"
"1150","2004_1197_1246",2004,137,"2004_1197",1197,"2004_1246",1246,16,20,4,1,1,0,-15,"Lose"
"1151","2004_1197_1250",2004,134,"2004_1197",1197,"2004_1250",1250,16,20,4,16,20,4,0,"Win"
"1152","2004_1196_1264",2004,136,"2004_1196",1196,"2004_1264",1264,5,2,-3,12,14,2,7,"Lose"
"1153","2004_1280_1284",2004,137,"2004_1280",1280,"2004_1284",1284,2,5,3,15,20,5,13,"Win"
"1154","2004_1228_1293",2004,137,"2004_1228",1228,"2004_1293",1293,5,4,-1,12,20,8,7,"Win"
"1155","2004_1277_1305",2004,136,"2004_1277",1277,"2004_1305",1305,7,7,0,10,20,10,3,"Lose"
"1156","2004_1211_1305",2004,138,"2004_1211",1211,"2004_1305",1305,2,9,7,10,20,10,8,"Lose"
"1157","2004_1210_1305",2004,144,"2004_1210",1210,"2004_1305",1305,3,20,17,10,20,10,7,"Win"
"1158","2004_1102_1314",2004,136,"2004_1102",1102,"2004_1314",1314,11,20,9,6,20,14,-5,"Lose"
"1159","2004_1210_1320",2004,137,"2004_1210",1210,"2004_1320",1320,3,20,17,14,20,6,11,"Win"
"1160","2004_1186_1329",2004,137,"2004_1186",1186,"2004_1329",1329,15,20,5,2,6,4,-13,"Lose"
"1161","2004_1210_1329",2004,152,"2004_1210",1210,"2004_1329",1329,3,20,17,2,6,4,-1,"Win"
"1162","2004_1272_1329",2004,139,"2004_1272",1272,"2004_1329",1329,7,7,0,2,6,4,-5,"Lose"
"1163","2004_1242_1334",2004,139,"2004_1242",1242,"2004_1334",1334,4,2,-2,12,20,8,8,"Win"
"1164","2004_1329_1338",2004,143,"2004_1329",1329,"2004_1338",1338,2,6,4,3,2,-1,1,"Win"
"1165","2004_1334_1344",2004,137,"2004_1334",1334,"2004_1344",1344,12,20,8,5,20,15,-7,"Win"
"1166","2004_1104_1356",2004,136,"2004_1104",1104,"2004_1356",1356,8,10,2,9,11,2,1,"Win"
"1167","2004_1112_1371",2004,136,"2004_1112",1112,"2004_1371",1371,9,1,-8,8,20,12,-1,"Lose"
"1168","2004_1181_1371",2004,138,"2004_1181",1181,"2004_1371",1371,1,3,2,8,20,12,7,"Win"
"1169","2004_1272_1376",2004,137,"2004_1272",1272,"2004_1376",1376,7,7,0,10,20,10,3,"Win"
"1170","2004_1251_1386",2004,136,"2004_1251",1251,"2004_1386",1386,16,20,4,1,7,6,-15,"Lose"
"1171","2004_1329_1386",2004,145,"2004_1329",1329,"2004_1386",1386,2,6,4,1,7,6,-1,"Win"
"1172","2004_1104_1390",2004,138,"2004_1104",1104,"2004_1390",1390,8,10,2,1,4,3,-7,"Win"
"1173","2004_1104_1393",2004,143,"2004_1104",1104,"2004_1393",1393,8,10,2,5,3,-2,-3,"Win"
"1174","2004_1268_1393",2004,138,"2004_1268",1268,"2004_1393",1393,4,6,2,5,3,-2,1,"Lose"
"1175","2004_1140_1393",2004,136,"2004_1140",1140,"2004_1393",1393,12,12,0,5,3,-2,-7,"Lose"
"1176","2004_1343_1400",2004,136,"2004_1343",1343,"2004_1400",1400,14,20,6,3,1,-2,-11,"Lose"
"1177","2004_1314_1400",2004,138,"2004_1314",1314,"2004_1400",1400,6,20,14,3,1,-2,-3,"Lose"
"1178","2004_1150_1403",2004,136,"2004_1150",1150,"2004_1403",1403,9,20,11,8,20,12,-1,"Lose"
"1179","2004_1386_1403",2004,138,"2004_1386",1386,"2004_1403",1403,1,7,6,8,20,12,7,"Win"
"1180","2004_1246_1412",2004,139,"2004_1246",1246,"2004_1412",1412,1,1,0,9,20,11,8,"Lose"
"1181","2004_1242_1412",2004,144,"2004_1242",1242,"2004_1412",1412,4,2,-2,9,20,11,5,"Win"
"1182","2004_1338_1416",2004,137,"2004_1338",1338,"2004_1416",1416,3,2,-1,14,20,6,11,"Win"
"1183","2004_1301_1418",2004,137,"2004_1301",1301,"2004_1418",1418,3,9,6,14,20,6,11,"Win"
"1184","2004_1390_1427",2004,136,"2004_1390",1390,"2004_1427",1427,1,4,3,16,20,4,15,"Win"
"1185","2004_1130_1428",2004,137,"2004_1130",1130,"2004_1428",1428,6,20,14,11,9,-2,5,"Win"
"1186","2004_1268_1431",2004,136,"2004_1268",1268,"2004_1431",1431,4,6,2,13,20,7,9,"Win"
"1187","2004_1211_1434",2004,136,"2004_1211",1211,"2004_1434",1434,2,9,7,15,20,5,13,"Win"
"1188","2004_1163_1435",2004,143,"2004_1163",1163,"2004_1435",1435,2,5,3,6,20,14,4,"Win"
"1189","2004_1301_1435",2004,139,"2004_1301",1301,"2004_1435",1435,3,9,6,6,20,14,3,"Lose"
"1190","2004_1163_1436",2004,136,"2004_1163",1163,"2004_1436",1436,2,5,3,15,16,1,13,"Win"
"1191","2004_1435_1444",2004,137,"2004_1435",1435,"2004_1444",1444,6,20,14,11,20,9,5,"Win"
"1192","2004_1264_1448",2004,138,"2004_1264",1264,"2004_1448",1448,12,14,2,4,2,-2,-8,"Lose"
"1193","2004_1433_1448",2004,136,"2004_1433",1433,"2004_1448",1448,13,20,7,4,2,-2,-9,"Lose"
"1194","2004_1386_1448",2004,143,"2004_1386",1386,"2004_1448",1448,1,7,6,4,2,-2,3,"Win"
"1195","2004_1412_1449",2004,137,"2004_1412",1412,"2004_1449",1449,9,20,11,8,20,12,-1,"Win"
"1196","2004_1350_1458",2004,137,"2004_1350",1350,"2004_1458",1458,11,20,9,6,5,-1,-5,"Lose"
"1197","2004_1338_1458",2004,139,"2004_1338",1338,"2004_1458",1458,3,2,-1,6,5,-1,3,"Win"
"1198","2004_1181_1462",2004,146,"2004_1181",1181,"2004_1462",1462,1,3,2,7,3,-4,6,"Win"
"1199","2004_1257_1462",2004,137,"2004_1257",1257,"2004_1462",1462,10,4,-6,7,3,-4,-3,"Lose"
"1200","2004_1400_1462",2004,144,"2004_1400",1400,"2004_1462",1462,3,1,-2,7,3,-4,4,"Lose"
"1201","2004_1280_1462",2004,139,"2004_1280",1280,"2004_1462",1462,2,5,3,7,3,-4,5,"Lose"
"1202","2005_1175_1181",2005,137,"2005_1175",1175,"2005_1181",1181,16,20,4,1,1,0,-15,"Lose"
"1203","2005_1203_1210",2005,137,"2005_1203",1203,"2005_1210",1210,12,20,8,5,3,-2,-7,"Lose"
"1204","2005_1112_1228",2005,145,"2005_1112",1112,"2005_1228",1228,3,9,6,1,5,4,-2,"Lose"
"1205","2005_1192_1228",2005,136,"2005_1192",1192,"2005_1228",1228,16,20,4,1,5,4,-15,"Lose"
"1206","2005_1153_1234",2005,136,"2005_1153",1153,"2005_1234",1234,7,4,-3,10,20,10,3,"Win"
"1207","2005_1137_1242",2005,137,"2005_1137",1137,"2005_1242",1242,14,20,6,3,4,1,-11,"Win"
"1208","2005_1184_1246",2005,136,"2005_1184",1184,"2005_1246",1246,15,20,5,2,1,-1,-13,"Lose"
"1209","2005_1153_1246",2005,138,"2005_1153",1153,"2005_1246",1246,7,4,-3,2,1,-1,-5,"Lose"
"1210","2005_1228_1257",2005,152,"2005_1228",1228,"2005_1257",1257,1,5,4,4,10,6,3,"Win"
"1211","2005_1210_1257",2005,139,"2005_1210",1210,"2005_1257",1257,5,3,-2,4,10,6,-1,"Lose"
"1212","2005_1246_1277",2005,146,"2005_1246",1246,"2005_1277",1277,2,1,-1,5,7,2,3,"Lose"
"1213","2005_1181_1277",2005,144,"2005_1181",1181,"2005_1277",1277,1,1,0,5,7,2,4,"Lose"
"1214","2005_1235_1278",2005,137,"2005_1235",1235,"2005_1278",1278,9,20,11,8,20,12,-1,"Win"
"1215","2005_1181_1280",2005,139,"2005_1181",1181,"2005_1280",1280,1,1,0,9,2,-7,8,"Win"
"1216","2005_1163_1301",2005,139,"2005_1163",1163,"2005_1301",1301,2,2,0,10,3,-7,8,"Lose"
"1217","2005_1150_1301",2005,137,"2005_1150",1150,"2005_1301",1301,7,9,2,10,3,-7,3,"Lose"
"1218","2005_1228_1305",2005,138,"2005_1228",1228,"2005_1305",1305,1,5,4,9,10,1,8,"Win"
"1219","2005_1235_1314",2005,139,"2005_1235",1235,"2005_1314",1314,9,20,11,1,6,5,-8,"Lose"
"1220","2005_1228_1314",2005,154,"2005_1228",1228,"2005_1314",1314,1,5,4,1,6,5,0,"Lose"
"1221","2005_1277_1314",2005,152,"2005_1277",1277,"2005_1314",1314,5,7,2,1,6,5,-4,"Lose"
"1222","2005_1105_1324",2005,134,"2005_1105",1105,"2005_1324",1324,16,20,4,16,20,4,0,"Lose"
"1223","2005_1314_1324",2005,137,"2005_1314",1314,"2005_1324",1324,1,6,5,16,20,4,15,"Win"
"1224","2005_1196_1325",2005,137,"2005_1196",1196,"2005_1325",1325,4,5,1,13,20,7,9,"Win"
"1225","2005_1310_1328",2005,136,"2005_1310",1310,"2005_1328",1328,14,20,6,3,20,17,-11,"Lose"
"1226","2005_1112_1329",2005,143,"2005_1112",1112,"2005_1329",1329,3,9,6,2,2,0,-1,"Win"
"1227","2005_1277_1330",2005,137,"2005_1277",1277,"2005_1330",1330,5,7,2,12,20,8,7,"Win"
"1228","2005_1130_1335",2005,136,"2005_1130",1130,"2005_1335",1335,4,6,2,13,20,7,9,"Win"
"1229","2005_1334_1338",2005,136,"2005_1334",1334,"2005_1338",1338,8,12,4,9,3,-6,1,"Win"
"1230","2005_1329_1356",2005,139,"2005_1329",1329,"2005_1356",1356,2,2,0,7,9,2,5,"Win"
"1231","2005_1329_1368",2005,137,"2005_1329",1329,"2005_1368",1368,2,2,0,15,20,5,13,"Win"
"1232","2005_1356_1388",2005,137,"2005_1356",1356,"2005_1388",1388,7,9,2,10,20,10,3,"Win"
"1233","2005_1280_1390",2005,137,"2005_1280",1280,"2005_1390",1390,9,2,-7,8,1,-7,-1,"Win"
"1234","2005_1305_1400",2005,136,"2005_1305",1305,"2005_1400",1400,9,10,1,8,3,-5,-1,"Win"
"1235","2005_1211_1403",2005,138,"2005_1211",1211,"2005_1403",1403,3,2,-1,6,8,2,3,"Lose"
"1236","2005_1261_1412",2005,136,"2005_1261",1261,"2005_1412",1412,6,20,14,11,9,-2,5,"Lose"
"1237","2005_1112_1412",2005,138,"2005_1112",1112,"2005_1412",1412,3,9,6,11,9,-2,8,"Win"
"1238","2005_1163_1416",2005,137,"2005_1163",1163,"2005_1416",1416,2,2,0,15,14,-1,13,"Win"
"1239","2005_1403_1417",2005,136,"2005_1403",1403,"2005_1417",1417,6,8,2,11,20,9,5,"Win"
"1240","2005_1257_1418",2005,137,"2005_1257",1257,"2005_1418",1418,4,10,6,13,14,1,9,"Win"
"1241","2005_1328_1428",2005,138,"2005_1328",1328,"2005_1428",1428,3,20,17,6,11,5,3,"Lose"
"1242","2005_1246_1428",2005,144,"2005_1246",1246,"2005_1428",1428,2,1,-1,6,11,5,4,"Win"
"1243","2005_1112_1429",2005,136,"2005_1112",1112,"2005_1429",1429,3,9,6,14,20,6,11,"Win"
"1244","2005_1428_1431",2005,136,"2005_1428",1428,"2005_1431",1431,6,11,5,11,13,2,5,"Win"
"1245","2005_1393_1436",2005,137,"2005_1393",1393,"2005_1436",1436,4,5,1,13,15,2,9,"Lose"
"1246","2005_1277_1436",2005,139,"2005_1277",1277,"2005_1436",1436,5,7,2,13,15,2,8,"Win"
"1247","2005_1314_1437",2005,144,"2005_1314",1314,"2005_1437",1437,1,6,5,5,20,15,4,"Win"
"1248","2005_1196_1437",2005,139,"2005_1196",1196,"2005_1437",1437,4,5,1,5,20,15,1,"Lose"
"1249","2005_1307_1437",2005,137,"2005_1307",1307,"2005_1437",1437,12,20,8,5,20,15,-7,"Lose"
"1250","2005_1151_1448",2005,136,"2005_1151",1151,"2005_1448",1448,15,20,5,2,4,2,-13,"Lose"
"1251","2005_1257_1449",2005,143,"2005_1257",1257,"2005_1449",1449,4,10,6,1,8,7,-3,"Win"
"1252","2005_1334_1449",2005,138,"2005_1334",1334,"2005_1449",1449,8,12,4,1,8,7,-7,"Lose"
"1253","2005_1285_1449",2005,136,"2005_1285",1285,"2005_1449",1449,16,20,4,1,8,7,-15,"Lose"
"1254","2005_1403_1452",2005,143,"2005_1403",1403,"2005_1452",1452,6,8,2,7,20,13,1,"Lose"
"1255","2005_1448_1452",2005,138,"2005_1448",1448,"2005_1452",1452,2,4,2,7,20,13,5,"Lose"
"1256","2005_1166_1452",2005,136,"2005_1166",1166,"2005_1452",1452,10,20,10,7,20,13,-3,"Lose"
"1257","2005_1257_1452",2005,145,"2005_1257",1257,"2005_1452",1452,4,10,6,7,20,13,3,"Win"
"1258","2005_1104_1454",2005,136,"2005_1104",1104,"2005_1454",1454,5,8,3,12,20,8,7,"Lose"
"1259","2005_1228_1454",2005,143,"2005_1228",1228,"2005_1454",1454,1,5,4,12,20,8,11,"Win"
"1260","2005_1130_1454",2005,138,"2005_1130",1130,"2005_1454",1454,4,6,2,12,20,8,8,"Lose"
"1261","2005_1211_1457",2005,136,"2005_1211",1211,"2005_1457",1457,3,2,-1,14,20,6,11,"Win"
"1262","2005_1320_1458",2005,137,"2005_1320",1320,"2005_1458",1458,11,14,3,6,6,0,-5,"Lose"
"1263","2005_1314_1458",2005,146,"2005_1314",1314,"2005_1458",1458,1,6,5,6,6,0,5,"Win"
"1264","2005_1137_1458",2005,139,"2005_1137",1137,"2005_1458",1458,14,20,6,6,6,0,-8,"Lose"
"1265","2005_1301_1458",2005,144,"2005_1301",1301,"2005_1458",1458,10,3,-7,6,6,0,-4,"Lose"
"1266","2006_1116_1137",2006,137,"2006_1116",1116,"2006_1137",1137,8,20,12,9,14,5,1,"Lose"
"1267","2006_1107_1163",2006,137,"2006_1107",1107,"2006_1163",1163,16,20,4,1,2,1,-15,"Lose"
"1268","2006_1181_1203",2006,138,"2006_1181",1181,"2006_1203",1203,1,1,0,8,12,4,7,"Win"
"1269","2006_1196_1206",2006,152,"2006_1196",1196,"2006_1206",1206,3,4,1,11,20,9,8,"Win"
"1270","2006_1163_1206",2006,146,"2006_1163",1163,"2006_1206",1206,1,2,1,11,20,9,10,"Lose"
"1271","2006_1196_1207",2006,144,"2006_1196",1196,"2006_1207",1207,3,4,1,7,20,13,4,"Win"
"1272","2006_1102_1228",2006,136,"2006_1102",1102,"2006_1228",1228,13,20,7,4,1,-3,-9,"Lose"
"1273","2006_1211_1231",2006,138,"2006_1211",1211,"2006_1231",1231,3,3,0,6,20,14,3,"Win"
"1274","2006_1133_1242",2006,137,"2006_1133",1133,"2006_1242",1242,13,20,7,4,3,-1,-9,"Win"
"1275","2006_1163_1246",2006,139,"2006_1163",1163,"2006_1246",1246,1,2,1,8,2,-6,7,"Win"
"1276","2006_1181_1261",2006,143,"2006_1181",1181,"2006_1261",1261,1,1,0,4,6,2,3,"Lose"
"1277","2006_1233_1261",2006,136,"2006_1233",1233,"2006_1261",1261,13,20,7,4,6,2,-9,"Lose"
"1278","2006_1104_1266",2006,136,"2006_1104",1104,"2006_1266",1266,10,5,-5,7,20,13,-3,"Win"
"1279","2006_1133_1272",2006,143,"2006_1133",1133,"2006_1272",1272,13,20,7,1,20,19,-12,"Lose"
"1280","2006_1137_1272",2006,139,"2006_1137",1137,"2006_1272",1272,9,14,5,1,20,19,-8,"Lose"
"1281","2006_1206_1277",2006,137,"2006_1206",1206,"2006_1277",1277,11,20,9,6,5,-1,-5,"Win"
"1282","2006_1214_1284",2006,134,"2006_1214",1214,"2006_1284",1284,16,20,4,16,20,4,0,"Lose"
"1283","2006_1130_1285",2006,138,"2006_1130",1130,"2006_1285",1285,4,4,0,12,16,4,8,"Win"
"1284","2006_1143_1301",2006,137,"2006_1143",1143,"2006_1301",1301,7,20,13,10,10,0,3,"Lose"
"1285","2006_1285_1305",2006,136,"2006_1285",1285,"2006_1305",1305,12,16,4,5,9,4,-7,"Win"
"1286","2006_1293_1314",2006,137,"2006_1293",1293,"2006_1314",1314,14,20,6,3,1,-2,-11,"Lose"
"1287","2006_1206_1314",2006,139,"2006_1206",1206,"2006_1314",1314,11,20,9,3,1,-2,-8,"Win"
"1288","2006_1207_1320",2006,137,"2006_1207",1207,"2006_1320",1320,7,20,13,10,11,1,3,"Win"
"1289","2006_1234_1322",2006,137,"2006_1234",1234,"2006_1322",1322,3,10,7,14,20,6,11,"Lose"
"1290","2006_1172_1326",2006,137,"2006_1172",1172,"2006_1326",1326,15,20,5,2,20,18,-13,"Lose"
"1291","2006_1207_1326",2006,139,"2006_1207",1207,"2006_1326",1326,7,20,13,2,20,18,-5,"Win"
"1292","2006_1272_1331",2006,137,"2006_1272",1272,"2006_1331",1331,1,20,19,16,20,4,15,"Win"
"1293","2006_1130_1334",2006,136,"2006_1130",1130,"2006_1334",1334,4,4,0,13,8,-5,9,"Win"
"1294","2006_1245_1338",2006,137,"2006_1245",1245,"2006_1338",1338,12,20,8,5,9,4,-7,"Lose"
"1295","2006_1133_1338",2006,139,"2006_1133",1133,"2006_1338",1338,13,20,7,5,9,4,-8,"Win"
"1296","2006_1231_1361",2006,136,"2006_1231",1231,"2006_1361",1361,6,20,14,11,20,9,5,"Win"
"1297","2006_1196_1375",2006,136,"2006_1196",1196,"2006_1375",1375,3,4,1,14,20,6,11,"Win"
"1298","2006_1181_1380",2006,136,"2006_1181",1181,"2006_1380",1380,1,1,0,16,20,4,15,"Win"
"1299","2006_1301_1400",2006,139,"2006_1301",1301,"2006_1400",1400,10,10,0,2,8,6,-8,"Lose"
"1300","2006_1335_1400",2006,137,"2006_1335",1335,"2006_1400",1400,15,13,-2,2,8,6,-13,"Lose"
"1301","2006_1261_1400",2006,145,"2006_1261",1261,"2006_1400",1400,4,6,2,2,8,6,-2,"Win"
"1302","2006_1393_1401",2006,136,"2006_1393",1393,"2006_1401",1401,5,4,-1,12,20,8,7,"Lose"
"1303","2006_1261_1401",2006,138,"2006_1261",1261,"2006_1401",1401,4,6,2,12,20,8,8,"Win"
"1304","2006_1246_1412",2006,137,"2006_1246",1246,"2006_1412",1412,8,2,-6,9,11,2,1,"Win"
"1305","2006_1104_1417",2006,138,"2006_1104",1104,"2006_1417",1417,10,5,-5,2,11,9,-8,"Lose"
"1306","2006_1125_1417",2006,136,"2006_1125",1125,"2006_1417",1417,15,20,5,2,11,9,-13,"Lose"
"1307","2006_1272_1417",2006,145,"2006_1272",1272,"2006_1417",1417,1,20,19,2,11,9,1,"Lose"
"1308","2006_1261_1417",2006,152,"2006_1261",1261,"2006_1417",1417,4,6,2,2,11,9,-2,"Lose"
"1309","2006_1211_1417",2006,143,"2006_1211",1211,"2006_1417",1417,3,3,0,2,11,9,-1,"Lose"
"1310","2006_1196_1417",2006,154,"2006_1196",1196,"2006_1417",1417,3,4,1,2,11,9,-1,"Win"
"1311","2006_1203_1423",2006,136,"2006_1203",1203,"2006_1423",1423,8,12,4,9,20,11,1,"Win"
"1312","2006_1284_1437",2006,137,"2006_1284",1284,"2006_1437",1437,16,20,4,1,5,4,-15,"Lose"
"1313","2006_1112_1437",2006,139,"2006_1112",1112,"2006_1437",1437,8,3,-5,1,5,4,-7,"Lose"
"1314","2006_1130_1437",2006,144,"2006_1130",1130,"2006_1437",1437,4,4,0,1,5,4,-3,"Lose"
"1315","2006_1196_1437",2006,146,"2006_1196",1196,"2006_1437",1437,3,4,1,1,5,4,-2,"Win"
"1316","2006_1228_1449",2006,138,"2006_1228",1228,"2006_1449",1449,4,1,-3,5,1,-4,1,"Lose"
"1317","2006_1163_1449",2006,144,"2006_1163",1163,"2006_1449",1449,1,2,1,5,1,-4,4,"Win"
"1318","2006_1429_1449",2006,136,"2006_1429",1429,"2006_1449",1449,12,14,2,5,1,-4,-7,"Lose"
"1319","2006_1322_1452",2006,139,"2006_1322",1322,"2006_1452",1452,14,20,6,6,7,1,-8,"Lose"
"1320","2006_1356_1452",2006,137,"2006_1356",1356,"2006_1452",1452,11,7,-4,6,7,1,-5,"Lose"
"1321","2006_1400_1452",2006,143,"2006_1400",1400,"2006_1452",1452,2,8,6,6,7,1,4,"Win"
"1322","2006_1328_1454",2006,136,"2006_1328",1328,"2006_1454",1454,6,3,-3,11,12,1,5,"Lose"
"1323","2006_1196_1454",2006,138,"2006_1196",1196,"2006_1454",1454,3,4,1,11,12,1,8,"Win"
"1324","2006_1206_1455",2006,144,"2006_1206",1206,"2006_1455",1455,11,20,9,7,20,13,-4,"Win"
"1325","2006_1397_1455",2006,138,"2006_1397",1397,"2006_1455",1455,2,20,18,7,20,13,5,"Lose"
"1326","2006_1371_1455",2006,136,"2006_1371",1371,"2006_1455",1455,10,20,10,7,20,13,-3,"Lose"
"1327","2006_1397_1457",2006,136,"2006_1397",1397,"2006_1457",1457,2,20,18,15,14,-1,13,"Win"
"1328","2006_1112_1458",2006,137,"2006_1112",1112,"2006_1458",1458,8,3,-5,9,6,-3,1,"Win"
"1329","2006_1211_1462",2006,136,"2006_1211",1211,"2006_1462",1462,3,3,0,14,20,6,11,"Win"
"1330","2007_1139_1196",2007,144,"2007_1139",1139,"2007_1196",1196,5,20,15,1,3,2,-4,"Lose"
"1331","2007_1130_1207",2007,138,"2007_1130",1130,"2007_1207",1207,7,4,-3,2,7,5,-5,"Lose"
"1332","2007_1125_1207",2007,136,"2007_1125",1125,"2007_1207",1207,15,15,0,2,7,5,-13,"Lose"
"1333","2007_1211_1231",2007,136,"2007_1211",1211,"2007_1231",1231,10,3,-7,7,6,-1,-3,"Lose"
"1334","2007_1196_1238",2007,137,"2007_1196",1196,"2007_1238",1238,1,3,2,16,20,4,15,"Win"
"1335","2007_1242_1246",2007,139,"2007_1242",1242,"2007_1246",1246,1,4,3,8,8,0,7,"Win"
"1336","2007_1139_1268",2007,138,"2007_1139",1139,"2007_1268",1268,5,20,15,4,20,16,-1,"Win"
"1337","2007_1172_1268",2007,136,"2007_1172",1172,"2007_1268",1268,13,15,2,4,20,16,-9,"Lose"
"1338","2007_1266_1277",2007,136,"2007_1266",1266,"2007_1277",1277,8,7,-1,9,6,-3,1,"Lose"
"1339","2007_1272_1305",2007,139,"2007_1272",1272,"2007_1305",1305,2,1,-1,7,5,-2,5,"Win"
"1340","2007_1166_1305",2007,137,"2007_1166",1166,"2007_1305",1305,10,20,10,7,5,-2,-3,"Lose"
"1341","2007_1197_1310",2007,134,"2007_1197",1197,"2007_1310",1310,16,20,4,16,20,4,0,"Lose"
"1342","2007_1242_1310",2007,137,"2007_1242",1242,"2007_1310",1310,1,4,3,16,20,4,15,"Win"
"1343","2007_1207_1314",2007,146,"2007_1207",1207,"2007_1314",1314,2,7,5,1,3,2,-1,"Win"
"1344","2007_1184_1314",2007,136,"2007_1184",1184,"2007_1314",1314,16,20,4,1,3,2,-15,"Lose"
"1345","2007_1277_1314",2007,138,"2007_1277",1277,"2007_1314",1314,9,6,-3,1,3,2,-8,"Lose"
"1346","2007_1272_1317",2007,137,"2007_1272",1272,"2007_1317",1317,2,1,-1,15,20,5,13,"Win"
"1347","2007_1207_1326",2007,152,"2007_1207",1207,"2007_1326",1326,2,7,5,1,2,1,-1,"Lose"
"1348","2007_1148_1326",2007,136,"2007_1148",1148,"2007_1326",1326,16,20,4,1,2,1,-15,"Lose"
"1349","2007_1272_1326",2007,145,"2007_1272",1272,"2007_1326",1326,2,1,-1,1,2,1,-1,"Lose"
"1350","2007_1196_1326",2007,154,"2007_1196",1196,"2007_1326",1326,1,3,2,1,2,1,0,"Win"
"1351","2007_1139_1330",2007,136,"2007_1139",1139,"2007_1330",1330,5,20,15,12,20,8,7,"Win"
"1352","2007_1275_1332",2007,137,"2007_1275",1275,"2007_1332",1332,14,20,6,3,20,17,-11,"Lose"
"1353","2007_1196_1332",2007,146,"2007_1196",1196,"2007_1332",1332,1,3,2,3,20,17,2,"Win"
"1354","2007_1112_1345",2007,137,"2007_1112",1112,"2007_1345",1345,8,8,0,9,20,11,1,"Lose"
"1355","2007_1196_1345",2007,139,"2007_1196",1196,"2007_1345",1345,1,3,2,9,20,11,8,"Win"
"1356","2007_1221_1356",2007,137,"2007_1221",1221,"2007_1356",1356,13,20,7,4,11,7,-9,"Lose"
"1357","2007_1242_1356",2007,143,"2007_1242",1242,"2007_1356",1356,1,4,3,4,11,7,3,"Win"
"1358","2007_1257_1390",2007,136,"2007_1257",1257,"2007_1390",1390,6,20,14,11,20,9,5,"Win"
"1359","2007_1326_1397",2007,143,"2007_1326",1326,"2007_1397",1397,1,2,1,5,2,-3,4,"Win"
"1360","2007_1253_1397",2007,137,"2007_1253",1253,"2007_1397",1397,12,20,8,5,2,-3,-7,"Lose"
"1361","2007_1308_1400",2007,137,"2007_1308",1308,"2007_1400",1400,13,20,7,4,2,-2,-9,"Lose"
"1362","2007_1257_1401",2007,138,"2007_1257",1257,"2007_1401",1401,6,20,14,3,12,9,-3,"Lose"
"1363","2007_1335_1401",2007,136,"2007_1335",1335,"2007_1401",1401,14,15,1,3,12,9,-11,"Lose"
"1364","2007_1272_1401",2007,143,"2007_1272",1272,"2007_1401",1401,2,1,-1,3,12,9,1,"Win"
"1365","2007_1130_1403",2007,136,"2007_1130",1130,"2007_1403",1403,7,4,-3,10,20,10,3,"Win"
"1366","2007_1231_1417",2007,138,"2007_1231",1231,"2007_1417",1417,7,6,-1,2,2,0,-5,"Lose"
"1367","2007_1338_1417",2007,143,"2007_1338",1338,"2007_1417",1417,3,5,2,2,2,0,-1,"Lose"
"1368","2007_1242_1417",2007,145,"2007_1242",1242,"2007_1417",1417,1,4,3,2,2,0,1,"Lose"
"1369","2007_1196_1417",2007,152,"2007_1196",1196,"2007_1417",1417,1,3,2,2,2,0,1,"Win"
"1370","2007_1210_1424",2007,137,"2007_1210",1210,"2007_1424",1424,10,20,10,7,20,13,-3,"Lose"
"1371","2007_1332_1424",2007,144,"2007_1332",1332,"2007_1424",1424,3,20,17,7,20,13,4,"Win"
"1372","2007_1400_1425",2007,139,"2007_1400",1400,"2007_1425",1425,4,2,-2,5,20,15,1,"Lose"
"1373","2007_1116_1425",2007,137,"2007_1116",1116,"2007_1425",1425,12,8,-4,5,20,15,-7,"Lose"
"1374","2007_1314_1425",2007,144,"2007_1314",1314,"2007_1425",1425,1,3,2,5,20,15,4,"Win"
"1375","2007_1338_1433",2007,138,"2007_1338",1338,"2007_1433",1433,3,5,2,11,20,9,8,"Win"
"1376","2007_1181_1433",2007,136,"2007_1181",1181,"2007_1433",1433,6,1,-5,11,20,9,5,"Lose"
"1377","2007_1207_1435",2007,144,"2007_1207",1207,"2007_1435",1435,2,7,5,6,20,14,4,"Win"
"1378","2007_1203_1435",2007,136,"2007_1203",1203,"2007_1435",1435,11,8,-3,6,20,14,-5,"Lose"
"1379","2007_1246_1437",2007,137,"2007_1246",1246,"2007_1437",1437,8,8,0,9,1,-8,1,"Win"
"1380","2007_1107_1438",2007,137,"2007_1107",1107,"2007_1438",1438,13,16,3,4,20,16,-9,"Lose"
"1381","2007_1397_1438",2007,139,"2007_1397",1397,"2007_1438",1438,5,2,-3,4,20,16,-1,"Win"
"1382","2007_1228_1439",2007,137,"2007_1228",1228,"2007_1439",1439,12,4,-8,5,20,15,-7,"Lose"
"1383","2007_1356_1439",2007,139,"2007_1356",1356,"2007_1439",1439,4,11,7,5,20,15,1,"Win"
"1384","2007_1331_1450",2007,136,"2007_1331",1331,"2007_1450",1450,14,16,2,3,20,17,-11,"Lose"
"1385","2007_1435_1450",2007,138,"2007_1435",1435,"2007_1450",1450,6,20,14,3,20,17,-3,"Win"
"1386","2007_1417_1451",2007,136,"2007_1417",1417,"2007_1451",1451,2,2,0,15,20,5,13,"Win"
"1387","2007_1332_1457",2007,139,"2007_1332",1332,"2007_1457",1457,3,20,17,11,15,4,8,"Win"
"1388","2007_1323_1457",2007,137,"2007_1323",1323,"2007_1457",1457,6,20,14,11,15,4,5,"Lose"
"1389","2007_1394_1458",2007,137,"2007_1394",1394,"2007_1458",1458,15,20,5,2,9,7,-13,"Lose"
"1390","2007_1424_1458",2007,139,"2007_1424",1424,"2007_1458",1458,7,20,13,2,9,7,-5,"Win"
"1391","2007_1338_1460",2007,136,"2007_1338",1338,"2007_1460",1460,3,5,2,14,20,6,11,"Win"
"1392","2007_1140_1462",2007,136,"2007_1140",1140,"2007_1462",1462,8,20,12,9,14,5,1,"Lose"
"1393","2007_1326_1462",2007,138,"2007_1326",1326,"2007_1462",1462,1,2,1,9,14,5,8,"Win"
"1394","2008_1125_1181",2008,136,"2008_1125",1125,"2008_1181",1181,15,15,0,2,6,4,-13,"Lose"
"1395","2008_1172_1207",2008,139,"2008_1172",1172,"2008_1207",1207,10,13,3,2,2,0,-8,"Win"
"1396","2008_1172_1211",2008,137,"2008_1172",1172,"2008_1211",1211,10,13,3,7,10,3,-3,"Win"
"1397","2008_1116_1231",2008,137,"2008_1116",1116,"2008_1231",1231,9,12,3,8,7,-1,-1,"Win"
"1398","2008_1172_1242",2008,146,"2008_1172",1172,"2008_1242",1242,10,13,3,1,1,0,-9,"Lose"
"1399","2008_1129_1257",2008,137,"2008_1129",1129,"2008_1257",1257,14,20,6,3,6,3,-11,"Lose"
"1400","2008_1246_1266",2008,136,"2008_1246",1246,"2008_1266",1266,11,8,-3,6,8,2,-5,"Lose"
"1401","2008_1242_1272",2008,154,"2008_1242",1242,"2008_1272",1272,1,1,0,1,2,1,0,"Win"
"1402","2008_1272_1277",2008,144,"2008_1272",1272,"2008_1277",1277,1,2,1,5,9,4,4,"Win"
"1403","2008_1272_1280",2008,139,"2008_1272",1272,"2008_1280",1280,1,2,1,8,20,12,7,"Win"
"1404","2008_1164_1291",2008,134,"2008_1164",1164,"2008_1291",1291,16,20,4,16,20,4,0,"Lose"
"1405","2008_1116_1314",2008,139,"2008_1116",1116,"2008_1314",1314,9,12,3,1,1,0,-8,"Lose"
"1406","2008_1291_1314",2008,137,"2008_1291",1291,"2008_1314",1314,16,20,4,1,1,0,-15,"Lose"
"1407","2008_1242_1314",2008,152,"2008_1242",1242,"2008_1314",1314,1,1,0,1,1,0,0,"Win"
"1408","2008_1257_1314",2008,145,"2008_1257",1257,"2008_1314",1314,3,6,3,1,1,0,-2,"Lose"
"1409","2008_1206_1323",2008,136,"2008_1206",1206,"2008_1323",1323,12,20,8,5,6,1,-7,"Lose"
"1410","2008_1257_1328",2008,139,"2008_1257",1257,"2008_1328",1328,3,6,3,6,20,14,3,"Win"
"1411","2008_1280_1332",2008,137,"2008_1280",1280,"2008_1332",1332,8,20,12,9,3,-6,1,"Win"
"1412","2008_1277_1338",2008,138,"2008_1277",1277,"2008_1338",1338,5,9,4,4,3,-1,-1,"Win"
"1413","2008_1331_1338",2008,136,"2008_1331",1331,"2008_1338",1338,13,14,1,4,3,-1,-9,"Lose"
"1414","2008_1242_1340",2008,136,"2008_1242",1242,"2008_1340",1340,1,1,0,16,20,4,15,"Win"
"1415","2008_1124_1345",2008,136,"2008_1124",1124,"2008_1345",1345,11,20,9,6,9,3,-5,"Lose"
"1416","2008_1163_1360",2008,137,"2008_1163",1163,"2008_1360",1360,4,20,16,13,20,7,9,"Lose"
"1417","2008_1139_1375",2008,137,"2008_1139",1139,"2008_1375",1375,7,5,-2,10,20,10,3,"Win"
"1418","2008_1328_1386",2008,137,"2008_1328",1328,"2008_1386",1386,6,20,14,11,20,9,5,"Win"
"1419","2008_1274_1388",2008,137,"2008_1274",1274,"2008_1388",1388,7,20,13,10,20,10,3,"Win"
"1420","2008_1165_1390",2008,136,"2008_1165",1165,"2008_1390",1390,14,20,6,3,11,8,-11,"Lose"
"1421","2008_1266_1390",2008,138,"2008_1266",1266,"2008_1390",1390,6,8,2,3,11,8,-3,"Lose"
"1422","2008_1277_1396",2008,136,"2008_1277",1277,"2008_1396",1396,5,9,4,12,20,8,7,"Win"
"1423","2008_1110_1397",2008,137,"2008_1110",1110,"2008_1397",1397,15,20,5,2,5,3,-13,"Lose"
"1424","2008_1257_1397",2008,143,"2008_1257",1257,"2008_1397",1397,3,6,3,2,5,3,-1,"Win"
"1425","2008_1139_1397",2008,139,"2008_1139",1139,"2008_1397",1397,7,5,-2,2,5,3,-5,"Lose"
"1426","2008_1122_1400",2008,137,"2008_1122",1122,"2008_1400",1400,15,20,5,2,4,2,-13,"Lose"
"1427","2008_1272_1400",2008,146,"2008_1272",1272,"2008_1400",1400,1,2,1,2,4,2,1,"Win"
"1428","2008_1390_1400",2008,144,"2008_1390",1390,"2008_1400",1400,3,11,8,2,4,2,-1,"Lose"
"1429","2008_1274_1400",2008,139,"2008_1274",1274,"2008_1400",1400,7,20,13,2,4,2,-5,"Lose"
"1430","2008_1140_1401",2008,136,"2008_1140",1140,"2008_1401",1401,8,8,0,9,3,-6,1,"Lose"
"1431","2008_1272_1417",2008,152,"2008_1272",1272,"2008_1417",1417,1,2,1,1,2,1,0,"Win"
"1432","2008_1401_1417",2008,138,"2008_1401",1401,"2008_1417",1417,9,3,-6,1,2,1,-8,"Lose"
"1433","2008_1290_1417",2008,136,"2008_1290",1290,"2008_1417",1417,16,20,4,1,2,1,-15,"Lose"
"1434","2008_1207_1420",2008,137,"2008_1207",1207,"2008_1420",1420,2,2,0,15,20,5,13,"Win"
"1435","2008_1245_1424",2008,136,"2008_1245",1245,"2008_1424",1424,9,20,11,8,7,-1,-1,"Lose"
"1436","2008_1242_1424",2008,138,"2008_1242",1242,"2008_1424",1424,1,1,0,8,7,-1,7,"Win"
"1437","2008_1243_1425",2008,136,"2008_1243",1243,"2008_1425",1425,11,20,9,6,5,-1,-5,"Win"
"1438","2008_1272_1426",2008,137,"2008_1272",1272,"2008_1426",1426,1,2,1,16,20,4,15,"Win"
"1439","2008_1373_1435",2008,137,"2008_1373",1373,"2008_1435",1435,13,20,7,4,6,2,-9,"Win"
"1440","2008_1373_1437",2008,139,"2008_1373",1373,"2008_1437",1437,13,20,7,12,9,-3,-1,"Lose"
"1441","2008_1155_1437",2008,137,"2008_1155",1155,"2008_1437",1437,5,20,15,12,9,-3,7,"Lose"
"1442","2008_1242_1437",2008,144,"2008_1242",1242,"2008_1437",1437,1,1,0,12,9,-3,11,"Win"
"1443","2008_1417_1443",2008,143,"2008_1417",1417,"2008_1443",1443,1,2,1,12,20,8,11,"Win"
"1444","2008_1179_1443",2008,137,"2008_1179",1179,"2008_1443",1443,5,20,15,12,20,8,7,"Lose"
"1445","2008_1360_1443",2008,139,"2008_1360",1360,"2008_1443",1443,13,20,7,12,20,8,-1,"Lose"
"1446","2008_1323_1450",2008,138,"2008_1323",1323,"2008_1450",1450,5,6,1,4,3,-1,-1,"Lose"
"1447","2008_1314_1450",2008,143,"2008_1314",1314,"2008_1450",1450,1,1,0,4,3,-1,3,"Win"
"1448","2008_1112_1452",2008,136,"2008_1112",1112,"2008_1452",1452,10,8,-2,7,20,13,-3,"Lose"
"1449","2008_1181_1452",2008,138,"2008_1181",1181,"2008_1452",1452,2,6,4,7,20,13,5,"Lose"
"1450","2008_1450_1457",2008,136,"2008_1450",1450,"2008_1457",1457,4,3,-1,13,11,-2,9,"Win"
"1451","2008_1243_1458",2008,138,"2008_1243",1243,"2008_1458",1458,11,20,9,3,2,-1,-8,"Lose"
"1452","2008_1168_1458",2008,136,"2008_1168",1168,"2008_1458",1458,14,20,6,3,2,-1,-11,"Lose"
"1453","2008_1172_1458",2008,144,"2008_1172",1172,"2008_1458",1458,10,13,3,3,2,-1,-7,"Win"
"1454","2008_1208_1462",2008,136,"2008_1208",1208,"2008_1462",1462,14,20,6,3,9,6,-11,"Lose"
"1455","2008_1417_1462",2008,145,"2008_1417",1417,"2008_1462",1462,1,2,1,3,9,6,2,"Win"
"1456","2008_1452_1462",2008,143,"2008_1452",1452,"2008_1462",1462,7,20,13,3,9,6,-4,"Lose"
"1457","2008_1345_1462",2008,138,"2008_1345",1345,"2008_1462",1462,6,9,3,3,9,6,-3,"Lose"
"1458","2009_1112_1156",2009,139,"2009_1112",1112,"2009_1156",1156,12,10,-2,13,20,7,1,"Win"
"1459","2009_1151_1163",2009,136,"2009_1151",1151,"2009_1163",1163,16,20,4,1,4,3,-15,"Lose"
"1460","2009_1127_1181",2009,136,"2009_1127",1127,"2009_1181",1181,15,20,5,2,2,0,-13,"Lose"
"1461","2009_1103_1211",2009,136,"2009_1103",1103,"2009_1211",1211,13,20,7,4,7,3,-9,"Lose"
"1462","2009_1173_1242",2009,139,"2009_1173",1173,"2009_1242",1242,11,20,9,3,1,-2,-8,"Lose"
"1463","2009_1112_1257",2009,144,"2009_1112",1112,"2009_1257",1257,12,10,-2,1,3,2,-11,"Lose"
"1464","2009_1139_1261",2009,136,"2009_1139",1139,"2009_1261",1261,9,7,-2,8,20,12,-1,"Lose"
"1465","2009_1143_1268",2009,136,"2009_1143",1143,"2009_1268",1268,7,20,13,10,20,10,3,"Lose"
"1466","2009_1169_1272",2009,136,"2009_1169",1169,"2009_1272",1272,15,20,5,2,1,-1,-13,"Lose"
"1467","2009_1268_1272",2009,138,"2009_1268",1268,"2009_1272",1272,10,20,10,2,1,-1,-8,"Lose"
"1468","2009_1155_1276",2009,136,"2009_1155",1155,"2009_1276",1276,7,5,-2,10,20,10,3,"Lose"
"1469","2009_1163_1277",2009,152,"2009_1163",1163,"2009_1277",1277,1,4,3,2,5,3,1,"Lose"
"1470","2009_1242_1277",2009,144,"2009_1242",1242,"2009_1277",1277,3,1,-2,2,5,3,-1,"Lose"
"1471","2009_1257_1277",2009,146,"2009_1257",1257,"2009_1277",1277,1,3,2,2,5,3,1,"Lose"
"1472","2009_1266_1281",2009,139,"2009_1266",1266,"2009_1281",1281,6,6,0,3,20,17,-3,"Lose"
"1473","2009_1163_1281",2009,145,"2009_1163",1163,"2009_1281",1281,1,4,3,3,20,17,2,"Win"
"1474","2009_1272_1281",2009,143,"2009_1272",1272,"2009_1281",1281,2,1,-1,3,20,17,1,"Lose"
"1475","2009_1165_1281",2009,137,"2009_1165",1165,"2009_1281",1281,14,14,0,3,20,17,-11,"Lose"
"1476","2009_1106_1287",2009,134,"2009_1106",1106,"2009_1287",1287,16,20,4,16,20,4,0,"Lose"
"1477","2009_1257_1287",2009,137,"2009_1257",1257,"2009_1287",1287,1,3,2,16,20,4,15,"Win"
"1478","2009_1242_1295",2009,137,"2009_1242",1242,"2009_1295",1295,3,1,-2,14,20,6,11,"Win"
"1479","2009_1277_1314",2009,154,"2009_1277",1277,"2009_1314",1314,2,5,3,1,1,0,-1,"Lose"
"1480","2009_1261_1314",2009,138,"2009_1261",1261,"2009_1314",1314,8,20,12,1,1,0,-7,"Lose"
"1481","2009_1211_1314",2009,144,"2009_1211",1211,"2009_1314",1314,4,7,3,1,1,0,-3,"Lose"
"1482","2009_1314_1328",2009,146,"2009_1314",1314,"2009_1328",1328,1,1,0,2,6,4,1,"Win"
"1483","2009_1288_1328",2009,136,"2009_1288",1288,"2009_1328",1328,15,20,5,2,6,4,-13,"Lose"
"1484","2009_1276_1328",2009,138,"2009_1276",1276,"2009_1328",1328,10,20,10,2,6,4,-8,"Lose"
"1485","2009_1190_1338",2009,137,"2009_1190",1190,"2009_1338",1338,16,20,4,1,4,3,-15,"Lose"
"1486","2009_1329_1338",2009,139,"2009_1329",1329,"2009_1338",1338,8,20,12,1,4,3,-7,"Lose"
"1487","2009_1163_1345",2009,143,"2009_1163",1163,"2009_1345",1345,1,4,3,5,6,1,4,"Win"
"1488","2009_1320_1345",2009,136,"2009_1320",1320,"2009_1345",1345,12,20,8,5,6,1,-7,"Lose"
"1489","2009_1314_1347",2009,136,"2009_1314",1314,"2009_1347",1347,1,1,0,16,20,4,15,"Win"
"1490","2009_1277_1352",2009,137,"2009_1277",1277,"2009_1352",1352,2,5,3,15,20,5,13,"Win"
"1491","2009_1326_1373",2009,137,"2009_1326",1326,"2009_1373",1373,8,20,12,9,13,4,1,"Lose"
"1492","2009_1257_1373",2009,139,"2009_1257",1257,"2009_1373",1373,1,3,2,9,13,4,8,"Win"
"1493","2009_1372_1393",2009,137,"2009_1372",1372,"2009_1393",1393,14,20,6,3,20,17,-11,"Lose"
"1494","2009_1113_1393",2009,139,"2009_1113",1113,"2009_1393",1393,6,20,14,3,20,17,-3,"Lose"
"1495","2009_1328_1393",2009,144,"2009_1328",1328,"2009_1393",1393,2,6,4,3,20,17,1,"Win"
"1496","2009_1113_1396",2009,137,"2009_1113",1113,"2009_1396",1396,6,20,14,11,12,1,5,"Win"
"1497","2009_1329_1397",2009,137,"2009_1329",1329,"2009_1397",1397,8,20,12,9,2,-7,1,"Win"
"1498","2009_1181_1400",2009,138,"2009_1181",1181,"2009_1400",1400,2,2,0,7,2,-5,5,"Win"
"1499","2009_1278_1400",2009,136,"2009_1278",1278,"2009_1400",1400,10,20,10,7,2,-5,-3,"Lose"
"1500","2009_1140_1401",2009,136,"2009_1140",1140,"2009_1401",1401,8,8,0,9,9,0,1,"Lose"
"1501","2009_1163_1401",2009,138,"2009_1163",1163,"2009_1401",1401,1,4,3,9,9,0,8,"Win"
"1502","2009_1130_1425",2009,137,"2009_1130",1130,"2009_1425",1425,7,20,13,10,6,-4,3,"Lose"
"1503","2009_1277_1425",2009,139,"2009_1277",1277,"2009_1425",1425,2,5,3,10,6,-4,8,"Win"
"1504","2009_1112_1428",2009,137,"2009_1112",1112,"2009_1428",1428,12,10,-2,5,20,15,-7,"Win"
"1505","2009_1266_1429",2009,137,"2009_1266",1266,"2009_1429",1429,6,6,0,11,20,9,5,"Win"
"1506","2009_1417_1433",2009,136,"2009_1417",1417,"2009_1433",1433,6,1,-5,11,20,9,5,"Win"
"1507","2009_1110_1437",2009,136,"2009_1110",1110,"2009_1437",1437,14,15,1,3,12,9,-11,"Lose"
"1508","2009_1338_1437",2009,145,"2009_1338",1338,"2009_1437",1437,1,4,3,3,12,9,2,"Lose"
"1509","2009_1314_1437",2009,152,"2009_1314",1314,"2009_1437",1437,1,1,0,3,12,9,2,"Win"
"1510","2009_1417_1437",2009,138,"2009_1417",1417,"2009_1437",1437,6,1,-5,3,12,9,-3,"Lose"
"1511","2009_1181_1437",2009,143,"2009_1181",1181,"2009_1437",1437,2,2,0,3,12,9,1,"Lose"
"1512","2009_1211_1443",2009,138,"2009_1211",1211,"2009_1443",1443,4,7,3,12,12,0,8,"Win"
"1513","2009_1228_1443",2009,136,"2009_1228",1228,"2009_1443",1443,5,20,15,12,12,0,7,"Lose"
"1514","2009_1156_1448",2009,137,"2009_1156",1156,"2009_1448",1448,13,20,7,4,20,16,-9,"Win"
"1515","2009_1280_1449",2009,136,"2009_1280",1280,"2009_1449",1449,13,8,-5,4,20,16,-9,"Lose"
"1516","2009_1345_1449",2009,138,"2009_1345",1345,"2009_1449",1449,5,6,1,4,20,16,-1,"Win"
"1517","2009_1173_1452",2009,137,"2009_1173",1173,"2009_1452",1452,11,20,9,6,7,1,-5,"Win"
"1518","2009_1199_1458",2009,137,"2009_1199",1199,"2009_1458",1458,5,20,15,12,3,-9,7,"Lose"
"1519","2009_1338_1462",2009,143,"2009_1338",1338,"2009_1462",1462,1,4,3,4,3,-1,3,"Win"
"1520","2009_1340_1462",2009,137,"2009_1340",1340,"2009_1462",1462,13,16,3,4,3,-1,-9,"Lose"
"1521","2009_1458_1462",2009,139,"2009_1458",1458,"2009_1462",1462,12,3,-9,4,3,-1,-8,"Lose"
"1522","2010_1115_1181",2010,137,"2010_1115",1115,"2010_1181",1181,16,20,4,1,2,1,-15,"Lose"
"1523","2010_1143_1181",2010,139,"2010_1143",1143,"2010_1181",1181,8,7,-1,1,2,1,-7,"Lose"
"1524","2010_1124_1181",2010,146,"2010_1124",1124,"2010_1181",1181,3,20,17,1,2,1,-2,"Lose"
"1525","2010_1139_1181",2010,154,"2010_1139",1139,"2010_1181",1181,5,9,4,1,2,1,-4,"Lose"
"1526","2010_1140_1196",2010,136,"2010_1140",1140,"2010_1196",1196,7,8,1,10,20,10,3,"Win"
"1527","2010_1199_1211",2010,137,"2010_1199",1199,"2010_1211",1211,9,5,-4,8,4,-4,-1,"Lose"
"1528","2010_1139_1243",2010,145,"2010_1139",1139,"2010_1243",1243,5,9,4,2,20,18,-3,"Win"
"1529","2010_1140_1243",2010,138,"2010_1140",1140,"2010_1243",1243,7,8,1,2,20,18,-5,"Lose"
"1530","2010_1190_1246",2010,136,"2010_1190",1190,"2010_1246",1246,16,16,0,1,20,19,-15,"Lose"
"1531","2010_1165_1246",2010,143,"2010_1165",1165,"2010_1246",1246,12,14,2,1,20,19,-11,"Lose"
"1532","2010_1242_1250",2010,136,"2010_1242",1242,"2010_1250",1250,1,3,2,16,20,4,15,"Win"
"1533","2010_1143_1257",2010,137,"2010_1143",1143,"2010_1257",1257,8,7,-1,9,1,-8,1,"Win"
"1534","2010_1222_1268",2010,137,"2010_1222",1222,"2010_1268",1268,13,20,7,4,10,6,-9,"Lose"
"1535","2010_1139_1277",2010,152,"2010_1139",1139,"2010_1277",1277,5,9,4,5,2,-3,0,"Win"
"1536","2010_1268_1277",2010,139,"2010_1268",1268,"2010_1277",1277,4,10,6,5,2,-3,1,"Lose"
"1537","2010_1155_1281",2010,137,"2010_1155",1155,"2010_1281",1281,7,7,0,10,3,-7,3,"Lose"
"1538","2010_1139_1293",2010,138,"2010_1139",1139,"2010_1293",1293,5,9,4,13,20,7,8,"Win"
"1539","2010_1285_1307",2010,136,"2010_1285",1285,"2010_1307",1307,14,20,6,3,20,17,-11,"Lose"
"1540","2010_1277_1308",2010,137,"2010_1277",1277,"2010_1308",1308,5,2,-3,12,20,8,7,"Win"
"1541","2010_1243_1317",2010,136,"2010_1243",1243,"2010_1317",1317,2,20,18,15,20,5,13,"Win"
"1542","2010_1242_1320",2010,138,"2010_1242",1242,"2010_1320",1320,1,3,2,9,12,3,8,"Lose"
"1543","2010_1277_1320",2010,144,"2010_1277",1277,"2010_1320",1320,5,2,-3,9,12,3,4,"Win"
"1544","2010_1207_1325",2010,136,"2010_1207",1207,"2010_1325",1325,3,20,17,14,20,6,11,"Lose"
"1545","2010_1210_1326",2010,139,"2010_1210",1210,"2010_1326",1326,10,20,10,2,8,6,-8,"Lose"
"1546","2010_1210_1329",2010,137,"2010_1210",1210,"2010_1329",1329,10,20,10,7,8,1,-3,"Win"
"1547","2010_1124_1330",2010,138,"2010_1124",1124,"2010_1330",1330,3,20,17,11,20,9,8,"Win"
"1548","2010_1323_1330",2010,136,"2010_1323",1323,"2010_1330",1330,6,20,14,11,20,9,5,"Lose"
"1549","2010_1324_1338",2010,137,"2010_1324",1324,"2010_1338",1338,14,20,6,3,1,-2,-11,"Lose"
"1550","2010_1181_1345",2010,144,"2010_1181",1181,"2010_1345",1345,1,2,1,4,5,1,3,"Win"
"1551","2010_1124_1358",2010,136,"2010_1124",1124,"2010_1358",1358,3,20,17,14,20,6,11,"Win"
"1552","2010_1326_1364",2010,137,"2010_1326",1326,"2010_1364",1364,2,8,6,15,20,5,13,"Win"
"1553","2010_1345_1373",2010,137,"2010_1345",1345,"2010_1373",1373,4,5,1,13,9,-4,9,"Win"
"1554","2010_1350_1388",2010,136,"2010_1350",1350,"2010_1388",1388,7,20,13,10,20,10,3,"Lose"
"1555","2010_1124_1388",2010,144,"2010_1124",1124,"2010_1388",1388,3,20,17,10,20,10,7,"Win"
"1556","2010_1211_1393",2010,139,"2010_1211",1211,"2010_1393",1393,8,4,-4,1,3,2,-7,"Lose"
"1557","2010_1139_1393",2010,143,"2010_1139",1139,"2010_1393",1393,5,9,4,1,3,2,-4,"Win"
"1558","2010_1165_1396",2010,137,"2010_1165",1165,"2010_1396",1396,12,14,2,5,11,6,-7,"Win"
"1559","2010_1326_1397",2010,144,"2010_1326",1326,"2010_1397",1397,2,8,6,6,9,3,4,"Lose"
"1560","2010_1361_1397",2010,136,"2010_1361",1361,"2010_1397",1397,11,20,9,6,9,3,-5,"Lose"
"1561","2010_1325_1397",2010,138,"2010_1325",1325,"2010_1397",1397,14,20,6,6,9,3,-8,"Lose"
"1562","2010_1277_1397",2010,146,"2010_1277",1277,"2010_1397",1397,5,2,-3,6,9,3,1,"Win"
"1563","2010_1345_1401",2010,139,"2010_1345",1345,"2010_1401",1401,4,5,1,5,9,4,1,"Win"
"1564","2010_1320_1424",2010,136,"2010_1320",1320,"2010_1424",1424,9,12,3,8,20,12,-1,"Win"
"1565","2010_1401_1429",2010,137,"2010_1401",1401,"2010_1429",1429,5,9,4,12,11,-1,7,"Win"
"1566","2010_1139_1431",2010,136,"2010_1139",1139,"2010_1431",1431,5,9,4,12,20,8,7,"Win"
"1567","2010_1293_1435",2010,136,"2010_1293",1293,"2010_1435",1435,13,20,7,4,20,16,-9,"Win"
"1568","2010_1393_1436",2010,137,"2010_1393",1393,"2010_1436",1436,1,3,2,16,20,4,15,"Win"
"1569","2010_1352_1437",2010,136,"2010_1352",1352,"2010_1437",1437,15,15,0,2,3,1,-13,"Lose"
"1570","2010_1388_1437",2010,138,"2010_1388",1388,"2010_1437",1437,10,20,10,2,3,1,-8,"Win"
"1571","2010_1400_1448",2010,136,"2010_1400",1400,"2010_1448",1448,8,7,-1,9,4,-5,1,"Lose"
"1572","2010_1246_1448",2010,138,"2010_1246",1246,"2010_1448",1448,1,20,19,9,4,-5,8,"Win"
"1573","2010_1266_1449",2010,136,"2010_1266",1266,"2010_1449",1449,6,6,0,11,4,-7,5,"Lose"
"1574","2010_1307_1449",2010,138,"2010_1307",1307,"2010_1449",1449,3,20,17,11,4,-7,8,"Lose"
"1575","2010_1281_1452",2010,139,"2010_1281",1281,"2010_1452",1452,10,3,-7,2,6,4,-8,"Lose"
"1576","2010_1288_1452",2010,137,"2010_1288",1288,"2010_1452",1452,15,15,0,2,6,4,-13,"Lose"
"1577","2010_1449_1452",2010,143,"2010_1449",1449,"2010_1452",1452,11,4,-7,2,6,4,-9,"Lose"
"1578","2010_1181_1452",2010,152,"2010_1181",1181,"2010_1452",1452,1,2,1,2,6,4,1,"Win"
"1579","2010_1246_1452",2010,145,"2010_1246",1246,"2010_1452",1452,1,20,19,2,6,4,1,"Lose"
"1580","2010_1115_1457",2010,134,"2010_1115",1115,"2010_1457",1457,16,20,4,16,20,4,0,"Win"
"1581","2010_1165_1458",2010,139,"2010_1165",1165,"2010_1458",1458,12,14,2,4,12,8,-8,"Win"
"1582","2010_1458_1459",2010,137,"2010_1458",1458,"2010_1459",1459,4,12,8,13,20,7,9,"Win"
"1583","2010_1278_1462",2010,137,"2010_1278",1278,"2010_1462",1462,11,10,-1,6,4,-2,-5,"Lose"
"1584","2010_1243_1462",2010,143,"2010_1243",1243,"2010_1462",1462,2,20,18,6,4,-2,4,"Win"
"1585","2010_1338_1462",2010,139,"2010_1338",1338,"2010_1462",1462,3,1,-2,6,4,-2,3,"Lose"
"1586","2011_1112_1163",2011,145,"2011_1112",1112,"2011_1163",1163,5,20,15,3,20,17,-2,"Lose"
"1587","2011_1153_1163",2011,138,"2011_1153",1153,"2011_1163",1163,6,20,14,3,20,17,-3,"Lose"
"1588","2011_1137_1163",2011,136,"2011_1137",1137,"2011_1163",1163,14,20,6,3,20,17,-11,"Lose"
"1589","2011_1139_1163",2011,154,"2011_1139",1139,"2011_1163",1163,8,5,-3,3,20,17,-5,"Lose"
"1590","2011_1112_1181",2011,143,"2011_1112",1112,"2011_1181",1181,5,20,15,1,1,0,-4,"Win"
"1591","2011_1139_1196",2011,145,"2011_1139",1139,"2011_1196",1196,8,5,-3,2,10,8,-6,"Win"
"1592","2011_1140_1196",2011,143,"2011_1140",1140,"2011_1196",1196,3,7,4,2,10,8,-1,"Lose"
"1593","2011_1140_1211",2011,138,"2011_1140",1140,"2011_1211",1211,3,7,4,11,8,-3,8,"Win"
"1594","2011_1181_1214",2011,137,"2011_1181",1181,"2011_1214",1214,1,1,0,16,20,4,15,"Win"
"1595","2011_1228_1242",2011,139,"2011_1228",1228,"2011_1242",1242,9,20,11,1,1,0,-8,"Lose"
"1596","2011_1131_1242",2011,137,"2011_1131",1131,"2011_1242",1242,16,20,4,1,1,0,-15,"Lose"
"1597","2011_1163_1246",2011,152,"2011_1163",1163,"2011_1246",1246,3,20,17,4,1,-3,1,"Win"
"1598","2011_1112_1272",2011,137,"2011_1112",1112,"2011_1272",1272,5,20,15,12,20,8,7,"Win"
"1599","2011_1181_1276",2011,139,"2011_1181",1181,"2011_1276",1276,1,1,0,8,20,12,7,"Win"
"1600","2011_1153_1281",2011,136,"2011_1153",1153,"2011_1281",1281,6,20,14,11,10,-1,5,"Win"
"1601","2011_1257_1287",2011,136,"2011_1257",1257,"2011_1287",1287,4,9,5,13,20,7,9,"Lose"
"1602","2011_1254_1314",2011,137,"2011_1254",1254,"2011_1314",1314,15,20,5,2,20,18,-13,"Lose"
"1603","2011_1246_1314",2011,146,"2011_1246",1246,"2011_1314",1314,4,1,-3,2,20,18,-2,"Win"
"1604","2011_1266_1314",2011,144,"2011_1266",1266,"2011_1314",1314,11,6,-5,2,20,18,-9,"Lose"
"1605","2011_1103_1323",2011,137,"2011_1103",1103,"2011_1323",1323,15,20,5,2,6,4,-13,"Lose"
"1606","2011_1199_1323",2011,139,"2011_1199",1199,"2011_1323",1323,10,9,-1,2,6,4,-8,"Win"
"1607","2011_1246_1326",2011,144,"2011_1246",1246,"2011_1326",1326,4,1,-3,1,2,1,-3,"Win"
"1608","2011_1206_1326",2011,139,"2011_1206",1206,"2011_1326",1326,8,20,12,1,2,1,-7,"Lose"
"1609","2011_1139_1330",2011,136,"2011_1139",1139,"2011_1330",1330,8,5,-3,9,11,2,1,"Win"
"1610","2011_1139_1338",2011,138,"2011_1139",1139,"2011_1338",1338,8,5,-3,1,3,2,-7,"Win"
"1611","2011_1246_1343",2011,136,"2011_1246",1246,"2011_1343",1343,4,1,-3,13,20,7,9,"Win"
"1612","2011_1287_1350",2011,138,"2011_1287",1287,"2011_1350",1350,13,20,7,12,7,-5,-1,"Lose"
"1613","2011_1242_1350",2011,144,"2011_1242",1242,"2011_1350",1350,1,1,0,12,7,-5,11,"Win"
"1614","2011_1294_1361",2011,136,"2011_1294",1294,"2011_1361",1361,15,20,5,2,11,9,-13,"Lose"
"1615","2011_1163_1361",2011,143,"2011_1163",1163,"2011_1361",1361,3,20,17,2,11,9,-1,"Win"
"1616","2011_1196_1364",2011,136,"2011_1196",1196,"2011_1364",1364,2,10,8,15,15,0,13,"Win"
"1617","2011_1211_1385",2011,136,"2011_1211",1211,"2011_1385",1385,11,8,-3,6,20,14,-5,"Win"
"1618","2011_1345_1389",2011,137,"2011_1345",1345,"2011_1389",1389,3,4,1,14,20,6,11,"Win"
"1619","2011_1232_1393",2011,137,"2011_1232",1232,"2011_1393",1393,14,20,6,3,1,-2,-11,"Lose"
"1620","2011_1266_1393",2011,139,"2011_1266",1266,"2011_1393",1393,11,6,-5,3,1,-2,-8,"Win"
"1621","2011_1336_1396",2011,136,"2011_1336",1336,"2011_1396",1396,10,20,10,7,5,-2,-3,"Lose"
"1622","2011_1361_1396",2011,138,"2011_1361",1361,"2011_1396",1396,2,11,9,7,5,-2,5,"Win"
"1623","2011_1276_1397",2011,137,"2011_1276",1276,"2011_1397",1397,8,20,12,9,6,-3,1,"Win"
"1624","2011_1324_1400",2011,137,"2011_1324",1324,"2011_1400",1400,13,14,1,4,8,4,-9,"Lose"
"1625","2011_1112_1400",2011,139,"2011_1112",1112,"2011_1400",1400,5,20,15,4,8,4,-1,"Win"
"1626","2011_1199_1401",2011,137,"2011_1199",1199,"2011_1401",1401,10,9,-1,7,5,-2,-3,"Win"
"1627","2011_1155_1412",2011,134,"2011_1155",1155,"2011_1412",1412,12,7,-5,12,20,8,0,"Win"
"1628","2011_1277_1417",2011,136,"2011_1277",1277,"2011_1417",1417,10,5,-5,7,20,13,-3,"Lose"
"1629","2011_1196_1417",2011,138,"2011_1196",1196,"2011_1417",1417,2,10,8,7,20,13,5,"Win"
"1630","2011_1114_1421",2011,134,"2011_1114",1114,"2011_1421",1421,16,20,4,16,20,4,0,"Lose"
"1631","2011_1338_1421",2011,136,"2011_1338",1338,"2011_1421",1421,1,3,2,16,20,4,15,"Win"
"1632","2011_1228_1424",2011,137,"2011_1228",1228,"2011_1424",1424,9,20,11,8,8,0,-1,"Win"
"1633","2011_1106_1427",2011,135,"2011_1106",1106,"2011_1427",1427,16,20,4,16,20,4,0,"Lose"
"1634","2011_1326_1427",2011,137,"2011_1326",1326,"2011_1427",1427,1,2,1,16,20,4,15,"Win"
"1635","2011_1243_1429",2011,136,"2011_1243",1243,"2011_1429",1429,5,2,-3,12,12,0,7,"Win"
"1636","2011_1139_1433",2011,152,"2011_1139",1139,"2011_1433",1433,8,5,-3,11,20,9,3,"Win"
"1637","2011_1425_1433",2011,135,"2011_1425",1425,"2011_1433",1433,11,20,9,11,20,9,0,"Lose"
"1638","2011_1345_1433",2011,139,"2011_1345",1345,"2011_1433",1433,3,4,1,11,20,9,8,"Lose"
"1639","2011_1199_1433",2011,144,"2011_1199",1199,"2011_1433",1433,10,9,-1,11,20,9,1,"Lose"
"1640","2011_1207_1433",2011,137,"2011_1207",1207,"2011_1433",1433,6,3,-3,11,20,9,5,"Lose"
"1641","2011_1242_1433",2011,146,"2011_1242",1242,"2011_1433",1433,1,1,0,11,20,9,10,"Lose"
"1642","2011_1350_1435",2011,136,"2011_1350",1350,"2011_1435",1435,12,7,-5,5,4,-1,-7,"Win"
"1643","2011_1206_1437",2011,137,"2011_1206",1206,"2011_1437",1437,8,20,12,9,2,-7,1,"Win"
"1644","2011_1314_1449",2011,139,"2011_1314",1314,"2011_1449",1449,2,20,18,7,11,4,5,"Win"
"1645","2011_1208_1449",2011,137,"2011_1208",1208,"2011_1449",1449,10,20,10,7,11,4,-3,"Lose"
"1646","2011_1155_1452",2011,136,"2011_1155",1155,"2011_1452",1452,12,7,-5,5,2,-3,-7,"Lose"
"1647","2011_1246_1452",2011,138,"2011_1246",1246,"2011_1452",1452,4,1,-3,5,2,-3,1,"Win"
"1648","2011_1139_1458",2011,143,"2011_1139",1139,"2011_1458",1458,8,5,-3,4,4,0,-4,"Win"
"1649","2011_1125_1458",2011,136,"2011_1125",1125,"2011_1458",1458,13,20,7,4,4,0,-9,"Lose"
"1650","2011_1243_1458",2011,138,"2011_1243",1243,"2011_1458",1458,5,2,-3,4,4,0,-1,"Lose"
"1651","2011_1140_1459",2011,136,"2011_1140",1140,"2011_1459",1459,3,7,4,14,13,-1,11,"Win"
"1652","2011_1266_1462",2011,137,"2011_1266",1266,"2011_1462",1462,11,6,-5,6,6,0,-5,"Win"
"1653","2012_1124_1160",2012,138,"2012_1124",1124,"2012_1160",1160,3,20,17,11,20,9,8,"Win"
"1654","2012_1104_1166",2012,137,"2012_1104",1104,"2012_1166",1166,9,20,11,8,20,12,-1,"Lose"
"1655","2012_1153_1199",2012,139,"2012_1153",1153,"2012_1199",1199,6,6,0,3,10,7,-3,"Win"
"1656","2012_1125_1207",2012,137,"2012_1125",1125,"2012_1207",1207,14,13,-1,3,6,3,-11,"Lose"
"1657","2012_1140_1233",2012,134,"2012_1140",1140,"2012_1233",1233,14,3,-11,14,20,6,0,"Win"
"1658","2012_1163_1235",2012,136,"2012_1163",1163,"2012_1235",1235,9,3,-6,8,20,12,-1,"Lose"
"1659","2012_1178_1242",2012,137,"2012_1178",1178,"2012_1242",1242,15,20,5,2,1,-1,-13,"Lose"
"1660","2012_1124_1246",2012,146,"2012_1124",1124,"2012_1246",1246,3,20,17,1,4,3,-2,"Lose"
"1661","2012_1231_1246",2012,144,"2012_1231",1231,"2012_1246",1246,4,20,16,1,4,3,-3,"Lose"
"1662","2012_1235_1246",2012,138,"2012_1235",1235,"2012_1246",1246,8,20,12,1,4,3,-7,"Lose"
"1663","2012_1242_1246",2012,154,"2012_1242",1242,"2012_1246",1246,2,1,-1,1,4,3,-1,"Lose"
"1664","2012_1181_1250",2012,137,"2012_1181",1181,"2012_1250",1250,2,1,-1,15,20,5,13,"Lose"
"1665","2012_1172_1257",2012,136,"2012_1172",1172,"2012_1257",1257,13,20,7,4,4,0,-9,"Lose"
"1666","2012_1196_1257",2012,145,"2012_1196",1196,"2012_1257",1257,7,2,-5,4,4,0,-3,"Lose"
"1667","2012_1246_1257",2012,152,"2012_1246",1246,"2012_1257",1257,1,4,3,4,4,0,3,"Win"
"1668","2012_1196_1266",2012,143,"2012_1196",1196,"2012_1266",1266,7,2,-5,3,11,8,-4,"Win"
"1669","2012_1140_1266",2012,136,"2012_1140",1140,"2012_1266",1266,14,3,-11,3,11,8,-11,"Lose"
"1670","2012_1257_1277",2012,143,"2012_1257",1257,"2012_1277",1277,4,4,0,1,10,9,-3,"Win"
"1671","2012_1254_1277",2012,137,"2012_1254",1254,"2012_1277",1277,16,15,-1,1,10,9,-15,"Lose"
"1672","2012_1266_1293",2012,138,"2012_1266",1266,"2012_1293",1293,3,11,8,6,20,14,3,"Win"
"1673","2012_1161_1293",2012,136,"2012_1161",1161,"2012_1293",1293,11,20,9,6,20,14,-5,"Lose"
"1674","2012_1207_1301",2012,139,"2012_1207",1207,"2012_1301",1301,3,6,3,11,20,9,8,"Lose"
"1675","2012_1242_1301",2012,144,"2012_1242",1242,"2012_1301",1301,2,1,-1,11,20,9,9,"Win"
"1676","2012_1257_1307",2012,138,"2012_1257",1257,"2012_1307",1307,4,4,0,5,20,15,1,"Win"
"1677","2012_1253_1307",2012,136,"2012_1253",1253,"2012_1307",1307,12,20,8,5,20,15,-7,"Lose"
"1678","2012_1231_1308",2012,136,"2012_1231",1231,"2012_1308",1308,4,20,16,13,20,7,9,"Win"
"1679","2012_1281_1313",2012,137,"2012_1281",1281,"2012_1313",1313,2,11,9,15,20,5,13,"Lose"
"1680","2012_1196_1313",2012,139,"2012_1196",1196,"2012_1313",1313,7,2,-5,15,20,5,8,"Win"
"1681","2012_1242_1314",2012,146,"2012_1242",1242,"2012_1314",1314,2,1,-1,1,2,1,-1,"Win"
"1682","2012_1166_1314",2012,139,"2012_1166",1166,"2012_1314",1314,8,20,12,1,2,1,-7,"Lose"
"1683","2012_1314_1325",2012,144,"2012_1314",1314,"2012_1325",1325,1,2,1,13,20,7,12,"Win"
"1684","2012_1276_1325",2012,137,"2012_1276",1276,"2012_1325",1325,4,8,4,13,20,7,9,"Lose"
"1685","2012_1211_1326",2012,138,"2012_1211",1211,"2012_1326",1326,7,11,4,2,1,-1,-5,"Lose"
"1686","2012_1259_1326",2012,136,"2012_1259",1259,"2012_1326",1326,15,20,5,2,1,-1,-13,"Lose"
"1687","2012_1242_1326",2012,152,"2012_1242",1242,"2012_1326",1326,2,1,-1,2,1,-1,0,"Win"
"1688","2012_1153_1326",2012,143,"2012_1153",1153,"2012_1326",1326,6,6,0,2,1,-1,-4,"Lose"
"1689","2012_1242_1345",2012,139,"2012_1242",1242,"2012_1345",1345,2,1,-1,10,3,-7,8,"Win"
"1690","2012_1124_1355",2012,136,"2012_1124",1124,"2012_1355",1355,3,20,17,14,20,6,11,"Win"
"1691","2012_1301_1361",2012,137,"2012_1301",1301,"2012_1361",1361,11,20,9,6,2,-4,-5,"Win"
"1692","2012_1143_1378",2012,135,"2012_1143",1143,"2012_1378",1378,12,20,8,12,20,8,0,"Lose"
"1693","2012_1325_1378",2012,139,"2012_1325",1325,"2012_1378",1378,13,20,7,12,20,8,-1,"Win"
"1694","2012_1243_1379",2012,136,"2012_1243",1243,"2012_1379",1379,8,5,-3,9,20,11,1,"Win"
"1695","2012_1199_1382",2012,137,"2012_1199",1199,"2012_1382",1382,3,10,7,14,20,6,11,"Win"
"1696","2012_1272_1387",2012,137,"2012_1272",1272,"2012_1387",1387,8,12,4,9,20,11,1,"Lose"
"1697","2012_1277_1387",2012,139,"2012_1277",1277,"2012_1387",1387,1,10,9,9,20,11,8,"Win"
"1698","2012_1345_1388",2012,137,"2012_1345",1345,"2012_1388",1388,10,3,-7,7,20,13,-3,"Win"
"1699","2012_1243_1393",2012,138,"2012_1243",1243,"2012_1393",1393,8,5,-3,1,3,2,-7,"Lose"
"1700","2012_1326_1393",2012,145,"2012_1326",1326,"2012_1393",1393,2,1,-1,1,3,2,-1,"Win"
"1701","2012_1378_1396",2012,137,"2012_1378",1378,"2012_1396",1396,12,20,8,5,7,2,-7,"Win"
"1702","2012_1153_1400",2012,137,"2012_1153",1153,"2012_1400",1400,6,6,0,11,4,-7,5,"Win"
"1703","2012_1393_1421",2012,136,"2012_1393",1393,"2012_1421",1421,1,3,2,16,16,0,15,"Win"
"1704","2012_1160_1424",2012,136,"2012_1160",1160,"2012_1424",1424,11,20,9,6,8,2,-5,"Win"
"1705","2012_1231_1433",2012,138,"2012_1231",1231,"2012_1433",1433,4,20,16,12,11,-1,8,"Win"
"1706","2012_1217_1435",2012,136,"2012_1217",1217,"2012_1435",1435,12,20,8,5,5,0,-7,"Lose"
"1707","2012_1314_1436",2012,137,"2012_1314",1314,"2012_1436",1436,1,2,1,16,20,4,15,"Win"
"1708","2012_1249_1436",2012,135,"2012_1249",1249,"2012_1436",1436,16,20,4,16,20,4,0,"Lose"
"1709","2012_1196_1438",2012,137,"2012_1196",1196,"2012_1438",1438,7,2,-5,10,20,10,3,"Win"
"1710","2012_1290_1443",2012,134,"2012_1290",1290,"2012_1443",1443,16,20,4,16,20,4,0,"Lose"
"1711","2012_1246_1443",2012,136,"2012_1246",1246,"2012_1443",1443,1,4,3,16,20,4,15,"Win"
"1712","2012_1211_1452",2012,136,"2012_1211",1211,"2012_1452",1452,7,11,4,10,5,-5,3,"Win"
"1713","2012_1433_1455",2012,136,"2012_1433",1433,"2012_1455",1455,12,11,-1,5,20,15,-7,"Win"
"1714","2012_1285_1458",2012,136,"2012_1285",1285,"2012_1458",1458,13,20,7,4,4,0,-9,"Lose"
"1715","2012_1393_1458",2012,143,"2012_1393",1393,"2012_1458",1458,1,3,2,4,4,0,3,"Win"
"1716","2012_1435_1458",2012,138,"2012_1435",1435,"2012_1458",1458,5,5,0,4,4,0,-1,"Lose"
"1717","2012_1124_1462",2012,144,"2012_1124",1124,"2012_1462",1462,3,20,17,10,6,-4,7,"Win"
"1718","2012_1250_1462",2012,139,"2012_1250",1250,"2012_1462",1462,15,20,5,10,6,-4,-5,"Lose"
"1719","2012_1323_1462",2012,137,"2012_1323",1323,"2012_1462",1462,7,2,-5,10,6,-4,3,"Lose"
"1720","2013_1112_1125",2013,136,"2013_1112",1112,"2013_1125",1125,6,20,14,11,14,3,5,"Win"
"1721","2013_1137_1139",2013,136,"2013_1137",1137,"2013_1139",1139,11,20,9,6,20,14,-5,"Lose"
"1722","2013_1153_1166",2013,137,"2013_1153",1153,"2013_1166",1166,10,6,-4,7,8,1,-3,"Lose"
"1723","2013_1107_1181",2013,137,"2013_1107",1107,"2013_1181",1181,15,20,5,2,2,0,-13,"Lose"
"1724","2013_1166_1181",2013,139,"2013_1166",1166,"2013_1181",1181,7,8,1,2,2,0,-5,"Lose"
"1725","2013_1195_1196",2013,144,"2013_1195",1195,"2013_1196",1196,15,20,5,3,7,4,-12,"Lose"
"1726","2013_1195_1207",2013,137,"2013_1195",1195,"2013_1207",1207,15,20,5,2,3,1,-13,"Win"
"1727","2013_1112_1217",2013,138,"2013_1112",1112,"2013_1217",1217,6,20,14,14,12,-2,8,"Win"
"1728","2013_1160_1228",2013,137,"2013_1160",1160,"2013_1228",1228,10,11,1,7,20,13,-3,"Lose"
"1729","2013_1231_1241",2013,137,"2013_1231",1231,"2013_1241",1241,1,4,3,16,20,4,15,"Win"
"1730","2013_1243_1247",2013,137,"2013_1243",1243,"2013_1247",1247,4,8,4,13,20,7,9,"Lose"
"1731","2013_1129_1247",2013,135,"2013_1129",1129,"2013_1247",1247,13,20,7,13,20,7,0,"Lose"
"1732","2013_1241_1254",2013,135,"2013_1241",1241,"2013_1254",1254,16,20,4,16,16,0,0,"Win"
"1733","2013_1161_1257",2013,138,"2013_1161",1161,"2013_1257",1257,8,11,3,1,4,3,-7,"Lose"
"1734","2013_1181_1257",2013,146,"2013_1181",1181,"2013_1257",1257,2,2,0,1,4,3,-1,"Lose"
"1735","2013_1139_1266",2013,138,"2013_1139",1139,"2013_1266",1266,6,20,14,3,3,0,-3,"Lose"
"1736","2013_1172_1266",2013,136,"2013_1172",1172,"2013_1266",1266,14,13,-1,3,3,0,-11,"Lose"
"1737","2013_1266_1274",2013,143,"2013_1266",1266,"2013_1274",1274,3,3,0,2,20,18,-1,"Win"
"1738","2013_1228_1274",2013,139,"2013_1228",1228,"2013_1274",1274,7,20,13,2,20,18,-5,"Lose"
"1739","2013_1196_1276",2013,146,"2013_1196",1196,"2013_1276",1276,3,7,4,4,4,0,1,"Lose"
"1740","2013_1257_1276",2013,154,"2013_1257",1257,"2013_1276",1276,1,4,3,4,4,0,3,"Win"
"1741","2013_1242_1276",2013,144,"2013_1242",1242,"2013_1276",1276,1,2,1,4,4,0,3,"Lose"
"1742","2013_1181_1277",2013,144,"2013_1181",1181,"2013_1277",1277,2,2,0,3,1,-2,1,"Win"
"1743","2013_1272_1277",2013,138,"2013_1272",1272,"2013_1277",1277,6,8,2,3,1,-2,-3,"Lose"
"1744","2013_1196_1278",2013,139,"2013_1196",1196,"2013_1278",1278,3,7,4,11,20,9,8,"Win"
"1745","2013_1247_1279",2013,139,"2013_1247",1247,"2013_1279",1279,13,20,7,12,20,8,-1,"Win"
"1746","2013_1161_1281",2013,136,"2013_1161",1161,"2013_1281",1281,8,11,3,9,2,-7,1,"Win"
"1747","2013_1257_1299",2013,136,"2013_1257",1257,"2013_1299",1299,1,4,3,16,20,4,15,"Win"
"1748","2013_1251_1299",2013,134,"2013_1251",1251,"2013_1299",1299,16,20,4,16,20,4,0,"Lose"
"1749","2013_1217_1307",2013,136,"2013_1217",1217,"2013_1307",1307,14,12,-2,3,5,2,-11,"Win"
"1750","2013_1242_1314",2013,139,"2013_1242",1242,"2013_1314",1314,1,2,1,8,1,-7,7,"Win"
"1751","2013_1196_1322",2013,137,"2013_1196",1196,"2013_1322",1322,3,7,4,14,20,6,11,"Win"
"1752","2013_1235_1323",2013,137,"2013_1235",1235,"2013_1323",1323,10,8,-2,7,7,0,-3,"Win"
"1753","2013_1112_1326",2013,143,"2013_1112",1112,"2013_1326",1326,6,20,14,2,2,0,-4,"Lose"
"1754","2013_1233_1326",2013,137,"2013_1233",1233,"2013_1326",1326,15,14,-1,2,2,0,-13,"Lose"
"1755","2013_1235_1326",2013,139,"2013_1235",1235,"2013_1326",1326,10,8,-2,2,2,0,-8,"Lose"
"1756","2013_1329_1332",2013,136,"2013_1329",1329,"2013_1332",1332,5,20,15,12,20,8,7,"Lose"
"1757","2013_1257_1332",2013,144,"2013_1257",1257,"2013_1332",1332,1,4,3,12,20,8,11,"Win"
"1758","2013_1274_1334",2013,137,"2013_1274",1274,"2013_1334",1334,2,20,18,15,20,5,13,"Win"
"1759","2013_1276_1355",2013,136,"2013_1276",1276,"2013_1355",1355,4,4,0,13,14,1,9,"Win"
"1760","2013_1195_1361",2013,139,"2013_1195",1195,"2013_1361",1361,15,20,5,7,6,-1,-8,"Win"
"1761","2013_1328_1361",2013,137,"2013_1328",1328,"2013_1361",1361,10,20,10,7,6,-1,-3,"Lose"
"1762","2013_1211_1380",2013,136,"2013_1211",1211,"2013_1380",1380,1,7,6,16,20,4,15,"Win"
"1763","2013_1332_1387",2013,138,"2013_1332",1332,"2013_1387",1387,12,20,8,4,9,5,-8,"Win"
"1764","2013_1308_1387",2013,136,"2013_1308",1308,"2013_1387",1387,13,13,0,4,9,5,-9,"Lose"
"1765","2013_1272_1388",2013,136,"2013_1272",1272,"2013_1388",1388,6,8,2,11,7,-4,5,"Win"
"1766","2013_1292_1388",2013,134,"2013_1292",1292,"2013_1388",1388,11,20,9,11,7,-4,0,"Lose"
"1767","2013_1143_1393",2013,138,"2013_1143",1143,"2013_1393",1393,12,12,0,4,1,-3,-8,"Lose"
"1768","2013_1276_1393",2013,152,"2013_1276",1276,"2013_1393",1393,4,4,0,4,1,-3,0,"Win"
"1769","2013_1266_1393",2013,145,"2013_1266",1266,"2013_1393",1393,3,3,0,4,1,-3,1,"Lose"
"1770","2013_1285_1393",2013,136,"2013_1285",1285,"2013_1393",1393,13,13,0,4,1,-3,-9,"Lose"
"1771","2013_1231_1393",2013,143,"2013_1231",1231,"2013_1393",1393,1,4,3,4,1,-3,3,"Lose"
"1772","2013_1301_1396",2013,137,"2013_1301",1301,"2013_1396",1396,8,11,3,9,5,-4,1,"Lose"
"1773","2013_1231_1396",2013,139,"2013_1231",1231,"2013_1396",1396,1,4,3,9,5,-4,8,"Win"
"1774","2013_1278_1417",2013,137,"2013_1278",1278,"2013_1417",1417,11,20,9,6,20,14,-5,"Win"
"1775","2013_1143_1424",2013,136,"2013_1143",1143,"2013_1424",1424,12,12,0,5,6,1,-7,"Win"
"1776","2013_1103_1433",2013,136,"2013_1103",1103,"2013_1433",1433,12,20,8,5,12,7,-7,"Lose"
"1777","2013_1276_1433",2013,138,"2013_1276",1276,"2013_1433",1433,4,4,0,5,12,7,1,"Win"
"1778","2013_1277_1434",2013,136,"2013_1277",1277,"2013_1434",1434,3,1,-2,14,20,6,11,"Win"
"1779","2013_1314_1437",2013,137,"2013_1314",1314,"2013_1437",1437,8,1,-7,9,20,11,1,"Win"
"1780","2013_1242_1443",2013,137,"2013_1242",1242,"2013_1443",1443,1,2,1,16,16,0,15,"Win"
"1781","2013_1211_1455",2013,138,"2013_1211",1211,"2013_1455",1455,1,7,6,9,5,-4,8,"Lose"
"1782","2013_1326_1455",2013,145,"2013_1326",1326,"2013_1455",1455,2,2,0,9,5,-4,7,"Lose"
"1783","2013_1338_1455",2013,136,"2013_1338",1338,"2013_1455",1455,8,20,12,9,5,-4,1,"Lose"
"1784","2013_1247_1455",2013,143,"2013_1247",1247,"2013_1455",1455,13,20,7,9,5,-4,-4,"Lose"
"1785","2013_1257_1455",2013,152,"2013_1257",1257,"2013_1455",1455,1,4,3,9,5,-4,8,"Win"
"1786","2013_1279_1458",2013,137,"2013_1279",1279,"2013_1458",1458,12,20,8,5,4,-1,-7,"Win"
"1787","2014_1124_1166",2014,139,"2014_1124",1124,"2014_1166",1166,6,20,14,3,7,4,-3,"Win"
"1788","2014_1107_1196",2014,136,"2014_1107",1107,"2014_1196",1196,16,15,-1,1,3,2,-15,"Lose"
"1789","2014_1163_1196",2014,152,"2014_1163",1163,"2014_1196",1196,7,20,13,1,3,2,-6,"Win"
"1790","2014_1173_1196",2014,145,"2014_1173",1173,"2014_1196",1196,11,20,9,1,3,2,-10,"Lose"
"1791","2014_1112_1211",2014,139,"2014_1112",1112,"2014_1211",1211,1,6,5,8,1,-7,7,"Win"
"1792","2014_1153_1217",2014,136,"2014_1153",1153,"2014_1217",1217,5,10,5,12,14,2,7,"Lose"
"1793","2014_1163_1235",2014,144,"2014_1163",1163,"2014_1235",1235,7,20,13,3,10,7,-4,"Win"
"1794","2014_1184_1242",2014,137,"2014_1184",1184,"2014_1242",1242,15,20,5,2,1,-1,-13,"Lose"
"1795","2014_1163_1246",2014,154,"2014_1163",1163,"2014_1246",1246,7,20,13,8,20,12,1,"Win"
"1796","2014_1243_1246",2014,137,"2014_1243",1243,"2014_1246",1246,9,4,-5,8,20,12,-1,"Lose"
"1797","2014_1246_1257",2014,144,"2014_1246",1246,"2014_1257",1257,8,20,12,4,1,-3,-4,"Win"
"1798","2014_1257_1264",2014,136,"2014_1257",1257,"2014_1264",1264,4,1,-3,13,20,7,9,"Win"
"1799","2014_1203_1272",2014,137,"2014_1203",1203,"2014_1272",1272,9,20,11,8,6,-2,-1,"Lose"
"1800","2014_1181_1273",2014,137,"2014_1181",1181,"2014_1273",1273,3,2,-1,14,20,6,11,"Lose"
"1801","2014_1246_1276",2014,146,"2014_1246",1246,"2014_1276",1276,8,20,12,2,4,2,-6,"Win"
"1802","2014_1174_1277",2014,136,"2014_1174",1174,"2014_1277",1277,13,20,7,4,3,-1,-9,"Lose"
"1803","2014_1217_1277",2014,138,"2014_1217",1217,"2014_1277",1277,12,14,2,4,3,-1,-8,"Lose"
"1804","2014_1163_1277",2014,146,"2014_1163",1163,"2014_1277",1277,7,20,13,4,3,-1,-3,"Win"
"1805","2014_1107_1291",2014,134,"2014_1107",1107,"2014_1291",1291,16,15,-1,16,20,4,0,"Win"
"1806","2014_1235_1300",2014,137,"2014_1235",1235,"2014_1300",1300,3,10,7,14,20,6,11,"Win"
"1807","2014_1124_1304",2014,137,"2014_1124",1124,"2014_1304",1304,6,20,14,11,20,9,5,"Win"
"1808","2014_1235_1314",2014,139,"2014_1235",1235,"2014_1314",1314,3,10,7,6,8,2,3,"Win"
"1809","2014_1173_1326",2014,136,"2014_1173",1173,"2014_1326",1326,11,20,9,6,2,-4,-5,"Win"
"1810","2014_1295_1328",2014,136,"2014_1295",1295,"2014_1328",1328,12,20,8,5,10,5,-7,"Win"
"1811","2014_1211_1329",2014,137,"2014_1211",1211,"2014_1329",1329,8,1,-7,9,5,-4,1,"Win"
"1812","2014_1140_1332",2014,136,"2014_1140",1140,"2014_1332",1332,10,20,10,7,12,5,-3,"Lose"
"1813","2014_1160_1338",2014,136,"2014_1160",1160,"2014_1338",1338,8,10,2,9,8,-1,1,"Lose"
"1814","2014_1196_1338",2014,138,"2014_1196",1196,"2014_1338",1338,1,3,2,9,8,-1,8,"Win"
"1815","2014_1314_1344",2014,137,"2014_1314",1314,"2014_1344",1344,6,8,2,11,20,9,5,"Win"
"1816","2014_1308_1361",2014,136,"2014_1308",1308,"2014_1361",1361,13,13,0,4,7,3,-9,"Lose"
"1817","2014_1295_1361",2014,138,"2014_1295",1295,"2014_1361",1361,12,20,8,4,7,3,-8,"Lose"
"1818","2014_1112_1361",2014,143,"2014_1112",1112,"2014_1361",1361,1,6,5,4,7,3,3,"Win"
"1819","2014_1163_1386",2014,136,"2014_1163",1163,"2014_1386",1386,7,20,13,10,20,10,3,"Win"
"1820","2014_1257_1387",2014,138,"2014_1257",1257,"2014_1387",1387,4,1,-3,5,4,-1,1,"Win"
"1821","2014_1301_1387",2014,136,"2014_1301",1301,"2014_1387",1387,12,8,-4,5,4,-1,-7,"Lose"
"1822","2014_1242_1390",2014,139,"2014_1242",1242,"2014_1390",1390,2,1,-1,10,20,10,8,"Lose"
"1823","2014_1307_1390",2014,137,"2014_1307",1307,"2014_1390",1390,7,3,-4,10,20,10,3,"Lose"
"1824","2014_1173_1390",2014,143,"2014_1173",1173,"2014_1390",1390,11,20,9,10,20,10,-1,"Win"
"1825","2014_1173_1393",2014,138,"2014_1173",1173,"2014_1393",1393,11,20,9,3,4,1,-8,"Win"
"1826","2014_1269_1397",2014,137,"2014_1269",1269,"2014_1397",1397,6,20,14,11,20,9,5,"Lose"
"1827","2014_1234_1397",2014,135,"2014_1234",1234,"2014_1397",1397,11,20,9,11,20,9,0,"Lose"
"1828","2014_1273_1397",2014,139,"2014_1273",1273,"2014_1397",1397,14,20,6,11,20,9,-3,"Lose"
"1829","2014_1276_1397",2014,144,"2014_1276",1276,"2014_1397",1397,2,4,2,11,20,9,9,"Win"
"1830","2014_1113_1400",2014,136,"2014_1113",1113,"2014_1400",1400,10,20,10,7,20,13,-3,"Lose"
"1831","2014_1276_1400",2014,138,"2014_1276",1276,"2014_1400",1400,2,4,2,7,20,13,5,"Win"
"1832","2014_1142_1411",2014,135,"2014_1142",1142,"2014_1411",1411,16,20,4,16,20,4,0,"Win"
"1833","2014_1372_1417",2014,139,"2014_1372",1372,"2014_1417",1417,12,20,8,4,6,2,-8,"Lose"
"1834","2014_1196_1417",2014,143,"2014_1196",1196,"2014_1417",1417,1,3,2,4,6,2,3,"Win"
"1835","2014_1409_1417",2014,137,"2014_1409",1409,"2014_1417",1417,13,20,7,4,6,2,-9,"Lose"
"1836","2014_1166_1418",2014,137,"2014_1166",1166,"2014_1418",1418,3,7,4,14,20,6,11,"Win"
"1837","2014_1372_1433",2014,137,"2014_1372",1372,"2014_1433",1433,12,20,8,5,5,0,-7,"Win"
"1838","2014_1163_1437",2014,138,"2014_1163",1163,"2014_1437",1437,7,20,13,2,9,7,-5,"Win"
"1839","2014_1157_1438",2014,137,"2014_1157",1157,"2014_1438",1438,16,20,4,1,20,19,-15,"Lose"
"1840","2014_1277_1438",2014,144,"2014_1277",1277,"2014_1438",1438,4,3,-1,1,20,19,-3,"Win"
"1841","2014_1272_1438",2014,139,"2014_1272",1272,"2014_1438",1438,8,6,-2,1,20,19,-7,"Lose"
"1842","2014_1393_1444",2014,136,"2014_1393",1393,"2014_1444",1444,3,4,1,14,20,6,11,"Win"
"1843","2014_1112_1451",2014,137,"2014_1112",1112,"2014_1451",1451,1,6,5,16,20,4,15,"Win"
"1844","2014_1437_1454",2014,136,"2014_1437",1437,"2014_1454",1454,2,9,7,15,20,5,13,"Win"
"1845","2014_1246_1455",2014,139,"2014_1246",1246,"2014_1455",1455,8,20,12,1,9,8,-7,"Win"
"1846","2014_1142_1455",2014,137,"2014_1142",1142,"2014_1455",1455,16,20,4,1,9,8,-15,"Lose"
"1847","2014_1110_1458",2014,136,"2014_1110",1110,"2014_1458",1458,15,20,5,2,5,3,-13,"Lose"
"1848","2014_1112_1458",2014,145,"2014_1112",1112,"2014_1458",1458,1,6,5,2,5,3,1,"Lose"
"1849","2014_1332_1458",2014,138,"2014_1332",1332,"2014_1458",1458,7,12,5,2,5,3,-5,"Lose"
"1850","2014_1246_1458",2014,152,"2014_1246",1246,"2014_1458",1458,8,20,12,2,5,3,-6,"Win"
"1851","2014_1124_1458",2014,143,"2014_1124",1124,"2014_1458",1458,6,20,14,2,5,3,-4,"Lose"
"1852","2014_1276_1459",2014,136,"2014_1276",1276,"2014_1459",1459,2,4,2,15,20,5,13,"Win"
"1853","2014_1301_1462",2014,134,"2014_1301",1301,"2014_1462",1462,12,8,-4,12,20,8,0,"Win"
"1854","2015_1129_1173",2015,135,"2015_1129",1129,"2015_1173",1173,11,20,9,11,11,0,0,"Lose"
"1855","2015_1186_1207",2015,136,"2015_1186",1186,"2015_1207",1207,13,20,7,4,20,16,-9,"Lose"
"1856","2015_1124_1209",2015,136,"2015_1124",1124,"2015_1209",1209,3,6,3,14,20,6,11,"Lose"
"1857","2015_1181_1211",2015,146,"2015_1181",1181,"2015_1211",1211,1,3,2,2,8,6,1,"Win"
"1858","2015_1172_1234",2015,137,"2015_1172",1172,"2015_1234",1234,10,20,10,7,11,4,-3,"Lose"
"1859","2015_1211_1234",2015,139,"2015_1211",1211,"2015_1234",1234,2,8,6,7,11,4,5,"Win"
"1860","2015_1214_1246",2015,136,"2015_1214",1214,"2015_1246",1246,16,20,4,1,8,7,-15,"Lose"
"1861","2015_1153_1246",2015,138,"2015_1153",1153,"2015_1246",1246,8,5,-3,1,8,7,-7,"Lose"
"1862","2015_1214_1264",2015,134,"2015_1214",1214,"2015_1264",1264,16,20,4,16,13,-3,0,"Win"
"1863","2015_1181_1277",2015,152,"2015_1181",1181,"2015_1277",1277,1,3,2,7,4,-3,6,"Win"
"1864","2015_1208_1277",2015,137,"2015_1208",1208,"2015_1277",1277,10,20,10,7,4,-3,-3,"Lose"
"1865","2015_1257_1277",2015,146,"2015_1257",1257,"2015_1277",1277,4,4,0,7,4,-3,3,"Lose"
"1866","2015_1140_1279",2015,134,"2015_1140",1140,"2015_1279",1279,11,10,-1,11,20,9,0,"Lose"
"1867","2015_1211_1295",2015,137,"2015_1211",1211,"2015_1295",1295,2,8,6,15,12,-3,13,"Win"
"1868","2015_1257_1301",2015,144,"2015_1257",1257,"2015_1301",1301,4,4,0,8,12,4,4,"Win"
"1869","2015_1261_1301",2015,136,"2015_1261",1261,"2015_1301",1301,9,20,11,8,12,4,-1,"Lose"
"1870","2015_1242_1308",2015,137,"2015_1242",1242,"2015_1308",1308,2,2,0,15,13,-2,13,"Win"
"1871","2015_1116_1314",2015,138,"2015_1116",1116,"2015_1314",1314,5,20,15,4,6,2,-1,"Lose"
"1872","2015_1217_1314",2015,136,"2015_1217",1217,"2015_1314",1314,13,12,-1,4,6,2,-9,"Lose"
"1873","2015_1257_1320",2015,139,"2015_1257",1257,"2015_1320",1320,4,4,0,5,20,15,1,"Win"
"1874","2015_1246_1323",2015,145,"2015_1246",1246,"2015_1323",1323,1,8,7,3,20,17,2,"Win"
"1875","2015_1318_1323",2015,136,"2015_1318",1318,"2015_1323",1323,14,20,6,3,20,17,-11,"Lose"
"1876","2015_1139_1323",2015,138,"2015_1139",1139,"2015_1323",1323,6,20,14,3,20,17,-3,"Lose"
"1877","2015_1112_1326",2015,138,"2015_1112",1112,"2015_1326",1326,2,1,-1,10,6,-4,8,"Win"
"1878","2015_1107_1328",2015,137,"2015_1107",1107,"2015_1328",1328,14,16,2,3,5,2,-11,"Lose"
"1879","2015_1173_1328",2015,139,"2015_1173",1173,"2015_1328",1328,11,11,0,3,5,2,-8,"Lose"
"1880","2015_1277_1328",2015,144,"2015_1277",1277,"2015_1328",1328,7,4,-3,3,5,2,-4,"Win"
"1881","2015_1329_1332",2015,137,"2015_1329",1329,"2015_1332",1332,9,9,0,8,7,-1,-1,"Lose"
"1882","2015_1173_1344",2015,137,"2015_1173",1173,"2015_1344",1344,11,11,0,6,11,5,-5,"Win"
"1883","2015_1153_1345",2015,136,"2015_1153",1153,"2015_1345",1345,8,5,-3,9,20,11,1,"Win"
"1884","2015_1316_1352",2015,135,"2015_1316",1316,"2015_1352",1352,16,20,4,16,20,4,0,"Lose"
"1885","2015_1181_1352",2015,137,"2015_1181",1181,"2015_1352",1352,1,3,2,16,20,4,15,"Win"
"1886","2015_1181_1361",2015,139,"2015_1181",1181,"2015_1361",1361,1,3,2,8,4,-4,7,"Win"
"1887","2015_1361_1385",2015,137,"2015_1361",1361,"2015_1385",1385,8,4,-4,9,20,11,1,"Win"
"1888","2015_1139_1400",2015,136,"2015_1139",1139,"2015_1400",1400,6,20,14,11,7,-4,5,"Win"
"1889","2015_1112_1411",2015,136,"2015_1112",1112,"2015_1411",1411,2,1,-1,15,16,1,13,"Win"
"1890","2015_1235_1412",2015,136,"2015_1235",1235,"2015_1412",1412,3,3,0,14,20,6,11,"Lose"
"1891","2015_1257_1414",2015,137,"2015_1257",1257,"2015_1414",1414,4,4,0,13,20,7,9,"Win"
"1892","2015_1211_1417",2015,144,"2015_1211",1211,"2015_1417",1417,2,8,6,11,4,-7,9,"Win"
"1893","2015_1412_1417",2015,138,"2015_1412",1412,"2015_1417",1417,14,20,6,11,4,-7,-3,"Lose"
"1894","2015_1374_1417",2015,136,"2015_1374",1374,"2015_1417",1417,6,20,14,11,4,-7,5,"Lose"
"1895","2015_1372_1428",2015,136,"2015_1372",1372,"2015_1428",1428,12,12,0,5,20,15,-7,"Lose"
"1896","2015_1181_1428",2015,144,"2015_1181",1181,"2015_1428",1428,1,3,2,5,20,15,4,"Win"
"1897","2015_1207_1428",2015,138,"2015_1207",1207,"2015_1428",1428,4,20,16,5,20,15,1,"Lose"
"1898","2015_1326_1433",2015,136,"2015_1326",1326,"2015_1433",1433,10,6,-4,7,5,-2,-3,"Win"
"1899","2015_1268_1434",2015,137,"2015_1268",1268,"2015_1434",1434,4,20,16,13,20,7,9,"Win"
"1900","2015_1248_1437",2015,136,"2015_1248",1248,"2015_1437",1437,16,20,4,1,2,1,-15,"Lose"
"1901","2015_1301_1437",2015,138,"2015_1301",1301,"2015_1437",1437,8,12,4,1,2,1,-7,"Win"
"1902","2015_1125_1438",2015,137,"2015_1125",1125,"2015_1438",1438,15,20,5,2,1,-1,-13,"Lose"
"1903","2015_1277_1438",2015,139,"2015_1277",1277,"2015_1438",1438,7,4,-3,2,1,-1,-5,"Win"
"1904","2015_1268_1452",2015,139,"2015_1268",1268,"2015_1452",1452,4,20,16,5,20,15,1,"Lose"
"1905","2015_1246_1452",2015,143,"2015_1246",1246,"2015_1452",1452,1,8,7,5,20,15,4,"Win"
"1906","2015_1138_1452",2015,137,"2015_1138",1138,"2015_1452",1452,12,20,8,5,20,15,-7,"Lose"
"1907","2015_1242_1455",2015,139,"2015_1242",1242,"2015_1455",1455,2,2,0,7,1,-6,5,"Lose"
"1908","2015_1323_1455",2015,143,"2015_1323",1323,"2015_1455",1455,3,20,17,7,1,-6,4,"Win"
"1909","2015_1231_1455",2015,137,"2015_1231",1231,"2015_1455",1455,10,20,10,7,1,-6,-3,"Lose"
"1910","2015_1112_1458",2015,145,"2015_1112",1112,"2015_1458",1458,2,1,-1,1,2,1,-1,"Lose"
"1911","2015_1332_1458",2015,139,"2015_1332",1332,"2015_1458",1458,8,7,-1,1,2,1,-7,"Lose"
"1912","2015_1314_1458",2015,143,"2015_1314",1314,"2015_1458",1458,4,6,2,1,2,1,-3,"Lose"
"1913","2015_1157_1458",2015,137,"2015_1157",1157,"2015_1458",1458,16,16,0,1,2,1,-15,"Lose"
"1914","2015_1246_1458",2015,152,"2015_1246",1246,"2015_1458",1458,1,8,7,1,2,1,0,"Lose"
"1915","2015_1181_1458",2015,154,"2015_1181",1181,"2015_1458",1458,1,3,2,1,2,1,0,"Win"
"1916","2015_1116_1459",2015,136,"2015_1116",1116,"2015_1459",1459,5,20,15,12,15,3,7,"Win"
"1917","2015_1320_1461",2015,137,"2015_1320",1320,"2015_1461",1461,5,20,15,12,20,8,7,"Win"
"1918","2015_1112_1462",2015,143,"2015_1112",1112,"2015_1462",1462,2,1,-1,6,12,6,4,"Win"
"1919","2015_1279_1462",2015,136,"2015_1279",1279,"2015_1462",1462,11,20,9,6,12,6,-5,"Lose"
"1920","2015_1209_1462",2015,138,"2015_1209",1209,"2015_1462",1462,14,20,6,6,12,6,-8,"Lose"
"1921","2016_1160_1163",2016,136,"2016_1160",1160,"2016_1163",1163,8,20,12,9,20,11,1,"Lose"
"1922","2016_1192_1195",2016,134,"2016_1192",1192,"2016_1195",1195,16,20,4,16,20,4,0,"Lose"
"1923","2016_1143_1218",2016,137,"2016_1143",1143,"2016_1218",1218,4,20,16,13,20,7,9,"Lose"
"1924","2016_1151_1231",2016,136,"2016_1151",1151,"2016_1231",1231,12,20,8,5,10,5,-7,"Lose"
"1925","2016_1233_1235",2016,136,"2016_1233",1233,"2016_1235",1235,13,20,7,4,3,-1,-9,"Lose"
"1926","2016_1114_1235",2016,138,"2016_1114",1114,"2016_1235",1235,12,20,8,4,3,-1,-8,"Lose"
"1927","2016_1122_1242",2016,136,"2016_1122",1122,"2016_1242",1242,16,20,4,1,2,1,-15,"Lose"
"1928","2016_1163_1242",2016,138,"2016_1163",1163,"2016_1242",1242,9,20,11,1,2,1,-8,"Lose"
"1929","2016_1231_1246",2016,138,"2016_1231",1231,"2016_1246",1246,5,10,5,4,1,-3,-1,"Win"
"1930","2016_1218_1268",2016,139,"2016_1218",1218,"2016_1268",1268,13,20,7,5,4,-1,-8,"Lose"
"1931","2016_1242_1268",2016,143,"2016_1242",1242,"2016_1268",1268,1,2,1,5,4,-1,4,"Win"
"1932","2016_1138_1274",2016,136,"2016_1138",1138,"2016_1274",1274,14,12,-2,3,20,17,-11,"Lose"
"1933","2016_1277_1292",2016,137,"2016_1277",1277,"2016_1292",1292,2,7,5,15,20,5,13,"Lose"
"1934","2016_1195_1314",2016,136,"2016_1195",1195,"2016_1314",1314,16,20,4,1,4,3,-15,"Lose"
"1935","2016_1231_1314",2016,144,"2016_1231",1231,"2016_1314",1314,5,10,5,1,4,3,-4,"Lose"
"1936","2016_1276_1323",2016,137,"2016_1276",1276,"2016_1323",1323,11,20,9,6,3,-3,-5,"Lose"
"1937","2016_1314_1323",2016,146,"2016_1314",1314,"2016_1323",1323,1,4,3,6,3,-3,5,"Win"
"1938","2016_1167_1328",2016,137,"2016_1167",1167,"2016_1328",1328,15,20,5,2,3,1,-13,"Lose"
"1939","2016_1221_1332",2016,137,"2016_1221",1221,"2016_1332",1332,16,20,4,1,8,7,-15,"Lose"
"1940","2016_1328_1332",2016,145,"2016_1328",1328,"2016_1332",1332,2,3,1,1,8,7,-1,"Win"
"1941","2016_1181_1332",2016,143,"2016_1181",1181,"2016_1332",1332,4,1,-3,1,8,7,-3,"Lose"
"1942","2016_1314_1344",2016,138,"2016_1314",1314,"2016_1344",1344,1,4,3,9,6,-3,8,"Win"
"1943","2016_1114_1345",2016,136,"2016_1114",1114,"2016_1345",1345,12,20,8,5,9,4,-7,"Win"
"1944","2016_1268_1355",2016,137,"2016_1268",1268,"2016_1355",1355,5,4,-1,12,20,8,7,"Win"
"1945","2016_1211_1371",2016,136,"2016_1211",1211,"2016_1371",1371,11,2,-9,6,20,14,-5,"Win"
"1946","2016_1323_1372",2016,139,"2016_1323",1323,"2016_1372",1372,6,3,-3,14,12,-2,8,"Win"
"1947","2016_1221_1380",2016,135,"2016_1221",1221,"2016_1380",1380,16,20,4,16,20,4,0,"Win"
"1948","2016_1153_1386",2016,137,"2016_1153",1153,"2016_1386",1386,9,8,-1,8,20,12,-1,"Lose"
"1949","2016_1332_1386",2016,139,"2016_1332",1332,"2016_1386",1386,1,8,7,8,20,12,7,"Win"
"1950","2016_1246_1392",2016,136,"2016_1246",1246,"2016_1392",1392,4,1,-3,13,20,7,9,"Win"
"1951","2016_1211_1393",2016,144,"2016_1211",1211,"2016_1393",1393,11,2,-9,10,20,10,-1,"Lose"
"1952","2016_1292_1393",2016,139,"2016_1292",1292,"2016_1393",1393,15,20,5,10,20,10,-5,"Lose"
"1953","2016_1173_1393",2016,137,"2016_1173",1173,"2016_1393",1393,7,11,4,10,20,10,3,"Lose"
"1954","2016_1314_1393",2016,152,"2016_1314",1314,"2016_1393",1393,1,4,3,10,20,10,9,"Win"
"1955","2016_1234_1396",2016,137,"2016_1234",1234,"2016_1396",1396,7,7,0,10,20,10,3,"Win"
"1956","2016_1320_1400",2016,137,"2016_1320",1320,"2016_1400",1400,11,5,-6,6,11,5,-5,"Win"
"1957","2016_1320_1401",2016,139,"2016_1320",1320,"2016_1401",1401,11,5,-6,3,20,17,-8,"Lose"
"1958","2016_1328_1401",2016,143,"2016_1328",1328,"2016_1401",1401,2,3,1,3,20,17,1,"Win"
"1959","2016_1139_1403",2016,136,"2016_1139",1139,"2016_1403",1403,9,6,-3,8,20,12,-1,"Win"
"1960","2016_1276_1409",2016,135,"2016_1276",1276,"2016_1409",1409,11,20,9,11,20,9,0,"Win"
"1961","2016_1181_1423",2016,136,"2016_1181",1181,"2016_1423",1423,4,1,-3,13,20,7,9,"Win"
"1962","2016_1344_1425",2016,136,"2016_1344",1344,"2016_1425",1425,9,6,-3,8,20,12,-1,"Win"
"1963","2016_1201_1428",2016,136,"2016_1201",1201,"2016_1428",1428,14,20,6,3,5,2,-11,"Lose"
"1964","2016_1211_1428",2016,138,"2016_1211",1211,"2016_1428",1428,11,2,-9,3,5,2,-8,"Win"
"1965","2016_1328_1433",2016,139,"2016_1328",1328,"2016_1433",1433,2,3,1,10,7,-3,8,"Win"
"1966","2016_1333_1433",2016,137,"2016_1333",1333,"2016_1433",1433,7,20,13,10,7,-3,3,"Lose"
"1967","2016_1421_1437",2016,137,"2016_1421",1421,"2016_1437",1437,15,20,5,2,1,-1,-13,"Lose"
"1968","2016_1242_1437",2016,145,"2016_1242",1242,"2016_1437",1437,1,2,1,2,1,-1,1,"Lose"
"1969","2016_1314_1437",2016,154,"2016_1314",1314,"2016_1437",1437,1,4,3,2,1,-1,1,"Lose"
"1970","2016_1274_1437",2016,143,"2016_1274",1274,"2016_1437",1437,3,20,17,2,1,-1,-1,"Lose"
"1971","2016_1234_1437",2016,139,"2016_1234",1234,"2016_1437",1437,7,7,0,2,1,-1,-5,"Lose"
"1972","2016_1328_1437",2016,152,"2016_1328",1328,"2016_1437",1437,2,3,1,2,1,-1,0,"Lose"
"1973","2016_1139_1438",2016,138,"2016_1139",1139,"2016_1438",1438,9,6,-3,1,2,1,-8,"Lose"
"1974","2016_1393_1438",2016,146,"2016_1393",1393,"2016_1438",1438,10,20,10,1,2,1,-9,"Win"
"1975","2016_1235_1438",2016,144,"2016_1235",1235,"2016_1438",1438,4,3,-1,1,2,1,-3,"Lose"
"1976","2016_1214_1438",2016,136,"2016_1214",1214,"2016_1438",1438,16,16,0,1,2,1,-15,"Lose"
"1977","2016_1372_1452",2016,137,"2016_1372",1372,"2016_1452",1452,14,12,-2,3,5,2,-11,"Win"
"1978","2016_1401_1453",2016,137,"2016_1401",1401,"2016_1453",1453,3,20,17,14,20,6,11,"Win"
"1979","2016_1112_1455",2016,136,"2016_1112",1112,"2016_1455",1455,6,2,-4,11,7,-4,5,"Lose"
"1980","2016_1274_1455",2016,138,"2016_1274",1274,"2016_1455",1455,3,20,17,11,7,-4,8,"Win"
"1981","2016_1435_1455",2016,134,"2016_1435",1435,"2016_1455",1455,11,20,9,11,7,-4,0,"Lose"
"1982","2016_1338_1458",2016,137,"2016_1338",1338,"2016_1458",1458,10,20,10,7,1,-6,-3,"Lose"
"1983","2016_1323_1458",2016,144,"2016_1323",1323,"2016_1458",1458,6,3,-3,7,1,-6,1,"Win"
"1984","2016_1451_1462",2016,137,"2016_1451",1451,"2016_1462",1462,15,20,5,2,6,4,-13,"Lose"
"1985","2016_1458_1462",2016,139,"2016_1458",1458,"2016_1462",1462,7,1,-6,2,6,4,-5,"Win"
"1986","2016_1181_1463",2016,138,"2016_1181",1181,"2016_1463",1463,4,1,-3,12,20,8,8,"Win"
"1987","2016_1124_1463",2016,136,"2016_1124",1124,"2016_1463",1463,5,3,-2,12,20,8,7,"Lose"
